Company,Account,GL Balance,IHub Balance,Balance Difference,Match Status,Discrepancy_Category,is_anomaly,Prompt
2,1618001,22676,93629,-70953,Break,Significant Discrepancy,1,"Company: 2, Account: 1618001, GL Balance: 22676, IHub Balance: 93629, Balance Difference: -70953, Match Status: Break, Discrepancy Category: Significant Discrepancy, Predicted Anomaly: Yes."
1,1618001,10055,75139,-65084,Break,Significant Discrepancy,1,"Company: 1, Account: 1618001, GL Balance: 10055, IHub Balance: 75139, Balance Difference: -65084, Match Status: Break, Discrepancy Category: Significant Discrepancy, Predicted Anomaly: Yes."
3,1618001,40720,69884,-29164,Break,Significant Discrepancy,1,"Company: 3, Account: 1618001, GL Balance: 40720, IHub Balance: 69884, Balance Difference: -29164, Match Status: Break, Discrepancy Category: Significant Discrepancy, Predicted Anomaly: Yes."
2,1618001,86853,64796,22057,Break,Significant Discrepancy,1,"Company: 2, Account: 1618001, GL Balance: 86853, IHub Balance: 64796, Balance Difference: 22057, Match Status: Break, Discrepancy Category: Significant Discrepancy, Predicted Anomaly: Yes."
1,1618001,91552,44263,47289,Break,Significant Discrepancy,1,"Company: 1, Account: 1618001, GL Balance: 91552, IHub Balance: 44263, Balance Difference: 47289, Match Status: Break, Discrepancy Category: Significant Discrepancy, Predicted Anomaly: Yes."
3,1618001,10560,96158,-85598,Break,Significant Discrepancy,1,"Company: 3, Account: 1618001, GL Balance: 10560, IHub Balance: 96158, Balance Difference: -85598, Match Status: Break, Discrepancy Category: Significant Discrepancy, Predicted Anomaly: Yes."
1,1618001,30707,32257,-1550,Break,Significant Discrepancy,1,"Company: 1, Account: 1618001, GL Balance: 30707, IHub Balance: 32257, Balance Difference: -1550, Match Status: Break, Discrepancy Category: Significant Discrepancy, Predicted Anomaly: Yes."
2,1618001,93637,73753,19884,Break,Significant Discrepancy,1,"Company: 2, Account: 1618001, GL Balance: 93637, IHub Balance: 73753, Balance Difference: 19884, Match Status: Break, Discrepancy Category: Significant Discrepancy, Predicted Anomaly: Yes."
1,1618001,66572,43957,22615,Break,Significant Discrepancy,1,"Company: 1, Account: 1618001, GL Balance: 66572, IHub Balance: 43957, Balance Difference: 22615, Match Status: Break, Discrepancy Category: Significant Discrepancy, Predicted Anomaly: Yes."
3,1618001,81667,33241,48426,Break,Significant Discrepancy,1,"Company: 3, Account: 1618001, GL Balance: 81667, IHub Balance: 33241, Balance Difference: 48426, Match Status: Break, Discrepancy Category: Significant Discrepancy, Predicted Anomaly: Yes."
1,1618001,87514,20846,66668,Break,Significant Discrepancy,1,"Company: 1, Account: 1618001, GL Balance: 87514, IHub Balance: 20846, Balance Difference: 66668, Match Status: Break, Discrepancy Category: Significant Discrepancy, Predicted Anomaly: Yes."
2,1618001,53032,58888,-5856,Break,Significant Discrepancy,1,"Company: 2, Account: 1618001, GL Balance: 53032, IHub Balance: 58888, Balance Difference: -5856, Match Status: Break, Discrepancy Category: Significant Discrepancy, Predicted Anomaly: Yes."
3,1618001,11195,31942,-20747,Break,Significant Discrepancy,1,"Company: 3, Account: 1618001, GL Balance: 11195, IHub Balance: 31942, Balance Difference: -20747, Match Status: Break, Discrepancy Category: Significant Discrepancy, Predicted Anomaly: Yes."
3,1618001,19852,10329,9523,Break,Significant Discrepancy,1,"Company: 3, Account: 1618001, GL Balance: 19852, IHub Balance: 10329, Balance Difference: 9523, Match Status: Break, Discrepancy Category: Significant Discrepancy, Predicted Anomaly: Yes."
1,1618001,91718,31573,60145,Break,Significant Discrepancy,1,"Company: 1, Account: 1618001, GL Balance: 91718, IHub Balance: 31573, Balance Difference: 60145, Match Status: Break, Discrepancy Category: Significant Discrepancy, Predicted Anomaly: Yes."
2,1618001,97948,63251,34697,Break,Significant Discrepancy,1,"Company: 2, Account: 1618001, GL Balance: 97948, IHub Balance: 63251, Balance Difference: 34697, Match Status: Break, Discrepancy Category: Significant Discrepancy, Predicted Anomaly: Yes."
3,1618001,17928,61667,-43739,Break,Significant Discrepancy,1,"Company: 3, Account: 1618001, GL Balance: 17928, IHub Balance: 61667, Balance Difference: -43739, Match Status: Break, Discrepancy Category: Significant Discrepancy, Predicted Anomaly: Yes."
1,1618001,56940,44229,12711,Break,Significant Discrepancy,1,"Company: 1, Account: 1618001, GL Balance: 56940, IHub Balance: 44229, Balance Difference: 12711, Match Status: Break, Discrepancy Category: Significant Discrepancy, Predicted Anomaly: Yes."
3,1618001,48015,34783,13232,Break,Significant Discrepancy,1,"Company: 3, Account: 1618001, GL Balance: 48015, IHub Balance: 34783, Balance Difference: 13232, Match Status: Break, Discrepancy Category: Significant Discrepancy, Predicted Anomaly: Yes."
1,1618001,45393,89054,-43661,Break,Significant Discrepancy,1,"Company: 1, Account: 1618001, GL Balance: 45393, IHub Balance: 89054, Balance Difference: -43661, Match Status: Break, Discrepancy Category: Significant Discrepancy, Predicted Anomaly: Yes."
2,1618001,44413,83391,-38978,Break,Significant Discrepancy,1,"Company: 2, Account: 1618001, GL Balance: 44413, IHub Balance: 83391, Balance Difference: -38978, Match Status: Break, Discrepancy Category: Significant Discrepancy, Predicted Anomaly: Yes."
3,1618001,85008,59582,25426,Break,Significant Discrepancy,1,"Company: 3, Account: 1618001, GL Balance: 85008, IHub Balance: 59582, Balance Difference: 25426, Match Status: Break, Discrepancy Category: Significant Discrepancy, Predicted Anomaly: Yes."
3,1618001,13747,43690,-29943,Break,Significant Discrepancy,1,"Company: 3, Account: 1618001, GL Balance: 13747, IHub Balance: 43690, Balance Difference: -29943, Match Status: Break, Discrepancy Category: Significant Discrepancy, Predicted Anomaly: Yes."
3,1618001,53397,75226,-21829,Break,Significant Discrepancy,1,"Company: 3, Account: 1618001, GL Balance: 53397, IHub Balance: 75226, Balance Difference: -21829, Match Status: Break, Discrepancy Category: Significant Discrepancy, Predicted Anomaly: Yes."
2,1618001,67745,30566,37179,Break,Significant Discrepancy,1,"Company: 2, Account: 1618001, GL Balance: 67745, IHub Balance: 30566, Balance Difference: 37179, Match Status: Break, Discrepancy Category: Significant Discrepancy, Predicted Anomaly: Yes."
2,1618001,71313,12892,58421,Break,Significant Discrepancy,1,"Company: 2, Account: 1618001, GL Balance: 71313, IHub Balance: 12892, Balance Difference: 58421, Match Status: Break, Discrepancy Category: Significant Discrepancy, Predicted Anomaly: Yes."
1,1618001,81035,82666,-1631,Break,Significant Discrepancy,1,"Company: 1, Account: 1618001, GL Balance: 81035, IHub Balance: 82666, Balance Difference: -1631, Match Status: Break, Discrepancy Category: Significant Discrepancy, Predicted Anomaly: Yes."
1,1618001,11353,24367,-13014,Break,Significant Discrepancy,1,"Company: 1, Account: 1618001, GL Balance: 11353, IHub Balance: 24367, Balance Difference: -13014, Match Status: Break, Discrepancy Category: Significant Discrepancy, Predicted Anomaly: Yes."
2,1618001,21254,40846,-19592,Break,Significant Discrepancy,1,"Company: 2, Account: 1618001, GL Balance: 21254, IHub Balance: 40846, Balance Difference: -19592, Match Status: Break, Discrepancy Category: Significant Discrepancy, Predicted Anomaly: Yes."
3,1618001,62551,97710,-35159,Break,Significant Discrepancy,1,"Company: 3, Account: 1618001, GL Balance: 62551, IHub Balance: 97710, Balance Difference: -35159, Match Status: Break, Discrepancy Category: Significant Discrepancy, Predicted Anomaly: Yes."
3,1618001,64097,85320,-21223,Break,Significant Discrepancy,1,"Company: 3, Account: 1618001, GL Balance: 64097, IHub Balance: 85320, Balance Difference: -21223, Match Status: Break, Discrepancy Category: Significant Discrepancy, Predicted Anomaly: Yes."
1,1618001,21294,30968,-9674,Break,Significant Discrepancy,1,"Company: 1, Account: 1618001, GL Balance: 21294, IHub Balance: 30968, Balance Difference: -9674, Match Status: Break, Discrepancy Category: Significant Discrepancy, Predicted Anomaly: Yes."
3,1618001,26365,60690,-34325,Break,Significant Discrepancy,1,"Company: 3, Account: 1618001, GL Balance: 26365, IHub Balance: 60690, Balance Difference: -34325, Match Status: Break, Discrepancy Category: Significant Discrepancy, Predicted Anomaly: Yes."
2,1618001,98147,54111,44036,Break,Significant Discrepancy,1,"Company: 2, Account: 1618001, GL Balance: 98147, IHub Balance: 54111, Balance Difference: 44036, Match Status: Break, Discrepancy Category: Significant Discrepancy, Predicted Anomaly: Yes."
1,1618001,92249,50597,41652,Break,Significant Discrepancy,1,"Company: 1, Account: 1618001, GL Balance: 92249, IHub Balance: 50597, Balance Difference: 41652, Match Status: Break, Discrepancy Category: Significant Discrepancy, Predicted Anomaly: Yes."
1,1618001,43371,18524,24847,Break,Significant Discrepancy,1,"Company: 1, Account: 1618001, GL Balance: 43371, IHub Balance: 18524, Balance Difference: 24847, Match Status: Break, Discrepancy Category: Significant Discrepancy, Predicted Anomaly: Yes."
2,1618001,23746,55647,-31901,Break,Significant Discrepancy,1,"Company: 2, Account: 1618001, GL Balance: 23746, IHub Balance: 55647, Balance Difference: -31901, Match Status: Break, Discrepancy Category: Significant Discrepancy, Predicted Anomaly: Yes."
1,1618001,36382,69155,-32773,Break,Significant Discrepancy,1,"Company: 1, Account: 1618001, GL Balance: 36382, IHub Balance: 69155, Balance Difference: -32773, Match Status: Break, Discrepancy Category: Significant Discrepancy, Predicted Anomaly: Yes."
1,1618001,57013,27824,29189,Break,Significant Discrepancy,1,"Company: 1, Account: 1618001, GL Balance: 57013, IHub Balance: 27824, Balance Difference: 29189, Match Status: Break, Discrepancy Category: Significant Discrepancy, Predicted Anomaly: Yes."
2,1618001,16849,85147,-68298,Break,Significant Discrepancy,1,"Company: 2, Account: 1618001, GL Balance: 16849, IHub Balance: 85147, Balance Difference: -68298, Match Status: Break, Discrepancy Category: Significant Discrepancy, Predicted Anomaly: Yes."
2,1618001,21340,54239,-32899,Break,Significant Discrepancy,1,"Company: 2, Account: 1618001, GL Balance: 21340, IHub Balance: 54239, Balance Difference: -32899, Match Status: Break, Discrepancy Category: Significant Discrepancy, Predicted Anomaly: Yes."
3,1618001,29971,65244,-35273,Break,Significant Discrepancy,1,"Company: 3, Account: 1618001, GL Balance: 29971, IHub Balance: 65244, Balance Difference: -35273, Match Status: Break, Discrepancy Category: Significant Discrepancy, Predicted Anomaly: Yes."
3,1618001,14947,93591,-78644,Break,Significant Discrepancy,1,"Company: 3, Account: 1618001, GL Balance: 14947, IHub Balance: 93591, Balance Difference: -78644, Match Status: Break, Discrepancy Category: Significant Discrepancy, Predicted Anomaly: Yes."
2,1618001,30431,47136,-16705,Break,Significant Discrepancy,1,"Company: 2, Account: 1618001, GL Balance: 30431, IHub Balance: 47136, Balance Difference: -16705, Match Status: Break, Discrepancy Category: Significant Discrepancy, Predicted Anomaly: Yes."
3,1618001,40869,84716,-43847,Break,Significant Discrepancy,1,"Company: 3, Account: 1618001, GL Balance: 40869, IHub Balance: 84716, Balance Difference: -43847, Match Status: Break, Discrepancy Category: Significant Discrepancy, Predicted Anomaly: Yes."
2,1618001,56910,59608,-2698,Break,Significant Discrepancy,1,"Company: 2, Account: 1618001, GL Balance: 56910, IHub Balance: 59608, Balance Difference: -2698, Match Status: Break, Discrepancy Category: Significant Discrepancy, Predicted Anomaly: Yes."
3,1618001,25754,55439,-29685,Break,Significant Discrepancy,1,"Company: 3, Account: 1618001, GL Balance: 25754, IHub Balance: 55439, Balance Difference: -29685, Match Status: Break, Discrepancy Category: Significant Discrepancy, Predicted Anomaly: Yes."
2,1618001,95192,19399,75793,Break,Significant Discrepancy,1,"Company: 2, Account: 1618001, GL Balance: 95192, IHub Balance: 19399, Balance Difference: 75793, Match Status: Break, Discrepancy Category: Significant Discrepancy, Predicted Anomaly: Yes."
3,1618001,48636,10565,38071,Break,Significant Discrepancy,1,"Company: 3, Account: 1618001, GL Balance: 48636, IHub Balance: 10565, Balance Difference: 38071, Match Status: Break, Discrepancy Category: Significant Discrepancy, Predicted Anomaly: Yes."
3,1618001,67032,79110,-12078,Break,Significant Discrepancy,1,"Company: 3, Account: 1618001, GL Balance: 67032, IHub Balance: 79110, Balance Difference: -12078, Match Status: Break, Discrepancy Category: Significant Discrepancy, Predicted Anomaly: Yes."
3,1618001,38067,29142,8925,Break,Significant Discrepancy,1,"Company: 3, Account: 1618001, GL Balance: 38067, IHub Balance: 29142, Balance Difference: 8925, Match Status: Break, Discrepancy Category: Significant Discrepancy, Predicted Anomaly: Yes."
3,1618001,68643,54706,13937,Break,Significant Discrepancy,1,"Company: 3, Account: 1618001, GL Balance: 68643, IHub Balance: 54706, Balance Difference: 13937, Match Status: Break, Discrepancy Category: Significant Discrepancy, Predicted Anomaly: Yes."
3,1618001,57553,43617,13936,Break,Significant Discrepancy,1,"Company: 3, Account: 1618001, GL Balance: 57553, IHub Balance: 43617, Balance Difference: 13936, Match Status: Break, Discrepancy Category: Significant Discrepancy, Predicted Anomaly: Yes."
2,1618001,15829,98667,-82838,Break,Significant Discrepancy,1,"Company: 2, Account: 1618001, GL Balance: 15829, IHub Balance: 98667, Balance Difference: -82838, Match Status: Break, Discrepancy Category: Significant Discrepancy, Predicted Anomaly: Yes."
2,1618001,61259,26450,34809,Break,Significant Discrepancy,1,"Company: 2, Account: 1618001, GL Balance: 61259, IHub Balance: 26450, Balance Difference: 34809, Match Status: Break, Discrepancy Category: Significant Discrepancy, Predicted Anomaly: Yes."
2,1618001,35318,33147,2171,Break,Significant Discrepancy,1,"Company: 2, Account: 1618001, GL Balance: 35318, IHub Balance: 33147, Balance Difference: 2171, Match Status: Break, Discrepancy Category: Significant Discrepancy, Predicted Anomaly: Yes."
1,1618001,57780,93346,-35566,Break,Significant Discrepancy,1,"Company: 1, Account: 1618001, GL Balance: 57780, IHub Balance: 93346, Balance Difference: -35566, Match Status: Break, Discrepancy Category: Significant Discrepancy, Predicted Anomaly: Yes."
2,1618001,83225,49199,34026,Break,Significant Discrepancy,1,"Company: 2, Account: 1618001, GL Balance: 83225, IHub Balance: 49199, Balance Difference: 34026, Match Status: Break, Discrepancy Category: Significant Discrepancy, Predicted Anomaly: Yes."
3,1618001,79687,92681,-12994,Break,Significant Discrepancy,1,"Company: 3, Account: 1618001, GL Balance: 79687, IHub Balance: 92681, Balance Difference: -12994, Match Status: Break, Discrepancy Category: Significant Discrepancy, Predicted Anomaly: Yes."
2,1618001,60617,50891,9726,Break,Significant Discrepancy,1,"Company: 2, Account: 1618001, GL Balance: 60617, IHub Balance: 50891, Balance Difference: 9726, Match Status: Break, Discrepancy Category: Significant Discrepancy, Predicted Anomaly: Yes."
2,1618001,12810,11212,1598,Break,Significant Discrepancy,1,"Company: 2, Account: 1618001, GL Balance: 12810, IHub Balance: 11212, Balance Difference: 1598, Match Status: Break, Discrepancy Category: Significant Discrepancy, Predicted Anomaly: Yes."
2,1618001,25659,76062,-50403,Break,Significant Discrepancy,1,"Company: 2, Account: 1618001, GL Balance: 25659, IHub Balance: 76062, Balance Difference: -50403, Match Status: Break, Discrepancy Category: Significant Discrepancy, Predicted Anomaly: Yes."
1,1618001,69860,19001,50859,Break,Significant Discrepancy,1,"Company: 1, Account: 1618001, GL Balance: 69860, IHub Balance: 19001, Balance Difference: 50859, Match Status: Break, Discrepancy Category: Significant Discrepancy, Predicted Anomaly: Yes."
1,1618001,93602,77061,16541,Break,Significant Discrepancy,1,"Company: 1, Account: 1618001, GL Balance: 93602, IHub Balance: 77061, Balance Difference: 16541, Match Status: Break, Discrepancy Category: Significant Discrepancy, Predicted Anomaly: Yes."
1,1618001,71509,15355,56154,Break,Significant Discrepancy,1,"Company: 1, Account: 1618001, GL Balance: 71509, IHub Balance: 15355, Balance Difference: 56154, Match Status: Break, Discrepancy Category: Significant Discrepancy, Predicted Anomaly: Yes."
2,1618001,43439,97744,-54305,Break,Significant Discrepancy,1,"Company: 2, Account: 1618001, GL Balance: 43439, IHub Balance: 97744, Balance Difference: -54305, Match Status: Break, Discrepancy Category: Significant Discrepancy, Predicted Anomaly: Yes."
3,1618001,34815,93184,-58369,Break,Significant Discrepancy,1,"Company: 3, Account: 1618001, GL Balance: 34815, IHub Balance: 93184, Balance Difference: -58369, Match Status: Break, Discrepancy Category: Significant Discrepancy, Predicted Anomaly: Yes."
1,1618001,63472,67275,-3803,Break,Significant Discrepancy,1,"Company: 1, Account: 1618001, GL Balance: 63472, IHub Balance: 67275, Balance Difference: -3803, Match Status: Break, Discrepancy Category: Significant Discrepancy, Predicted Anomaly: Yes."
3,1618001,32211,55227,-23016,Break,Significant Discrepancy,1,"Company: 3, Account: 1618001, GL Balance: 32211, IHub Balance: 55227, Balance Difference: -23016, Match Status: Break, Discrepancy Category: Significant Discrepancy, Predicted Anomaly: Yes."
1,1618001,69321,56874,12447,Break,Significant Discrepancy,1,"Company: 1, Account: 1618001, GL Balance: 69321, IHub Balance: 56874, Balance Difference: 12447, Match Status: Break, Discrepancy Category: Significant Discrepancy, Predicted Anomaly: Yes."
1,1618001,11245,52679,-41434,Break,Significant Discrepancy,1,"Company: 1, Account: 1618001, GL Balance: 11245, IHub Balance: 52679, Balance Difference: -41434, Match Status: Break, Discrepancy Category: Significant Discrepancy, Predicted Anomaly: Yes."
1,1618001,62683,78112,-15429,Break,Significant Discrepancy,1,"Company: 1, Account: 1618001, GL Balance: 62683, IHub Balance: 78112, Balance Difference: -15429, Match Status: Break, Discrepancy Category: Significant Discrepancy, Predicted Anomaly: Yes."
3,1618001,53516,48165,5351,Break,Significant Discrepancy,1,"Company: 3, Account: 1618001, GL Balance: 53516, IHub Balance: 48165, Balance Difference: 5351, Match Status: Break, Discrepancy Category: Significant Discrepancy, Predicted Anomaly: Yes."
1,1618001,25775,64079,-38304,Break,Significant Discrepancy,1,"Company: 1, Account: 1618001, GL Balance: 25775, IHub Balance: 64079, Balance Difference: -38304, Match Status: Break, Discrepancy Category: Significant Discrepancy, Predicted Anomaly: Yes."
1,1618001,43725,58094,-14369,Break,Significant Discrepancy,1,"Company: 1, Account: 1618001, GL Balance: 43725, IHub Balance: 58094, Balance Difference: -14369, Match Status: Break, Discrepancy Category: Significant Discrepancy, Predicted Anomaly: Yes."
1,1618001,88025,87214,811,Match,Other,0,"Company: 1, Account: 1618001, GL Balance: 88025, IHub Balance: 87214, Balance Difference: 811, Match Status: Match, Discrepancy Category: Other, Predicted Anomaly: No."
2,1618001,61529,54512,7017,Break,Significant Discrepancy,1,"Company: 2, Account: 1618001, GL Balance: 61529, IHub Balance: 54512, Balance Difference: 7017, Match Status: Break, Discrepancy Category: Significant Discrepancy, Predicted Anomaly: Yes."
1,1618001,11312,57850,-46538,Break,Significant Discrepancy,1,"Company: 1, Account: 1618001, GL Balance: 11312, IHub Balance: 57850, Balance Difference: -46538, Match Status: Break, Discrepancy Category: Significant Discrepancy, Predicted Anomaly: Yes."
1,1618001,67888,93161,-25273,Break,Significant Discrepancy,1,"Company: 1, Account: 1618001, GL Balance: 67888, IHub Balance: 93161, Balance Difference: -25273, Match Status: Break, Discrepancy Category: Significant Discrepancy, Predicted Anomaly: Yes."
2,1618001,29420,66494,-37074,Break,Significant Discrepancy,1,"Company: 2, Account: 1618001, GL Balance: 29420, IHub Balance: 66494, Balance Difference: -37074, Match Status: Break, Discrepancy Category: Significant Discrepancy, Predicted Anomaly: Yes."
3,1618001,11105,78754,-67649,Break,Significant Discrepancy,1,"Company: 3, Account: 1618001, GL Balance: 11105, IHub Balance: 78754, Balance Difference: -67649, Match Status: Break, Discrepancy Category: Significant Discrepancy, Predicted Anomaly: Yes."
3,1618001,16533,11995,4538,Break,Significant Discrepancy,1,"Company: 3, Account: 1618001, GL Balance: 16533, IHub Balance: 11995, Balance Difference: 4538, Match Status: Break, Discrepancy Category: Significant Discrepancy, Predicted Anomaly: Yes."
2,1618001,20095,92016,-71921,Break,Significant Discrepancy,1,"Company: 2, Account: 1618001, GL Balance: 20095, IHub Balance: 92016, Balance Difference: -71921, Match Status: Break, Discrepancy Category: Significant Discrepancy, Predicted Anomaly: Yes."
1,1618001,27290,93609,-66319,Break,Significant Discrepancy,1,"Company: 1, Account: 1618001, GL Balance: 27290, IHub Balance: 93609, Balance Difference: -66319, Match Status: Break, Discrepancy Category: Significant Discrepancy, Predicted Anomaly: Yes."
3,1618001,19304,98738,-79434,Break,Significant Discrepancy,1,"Company: 3, Account: 1618001, GL Balance: 19304, IHub Balance: 98738, Balance Difference: -79434, Match Status: Break, Discrepancy Category: Significant Discrepancy, Predicted Anomaly: Yes."
2,1618001,11695,23418,-11723,Break,Significant Discrepancy,1,"Company: 2, Account: 1618001, GL Balance: 11695, IHub Balance: 23418, Balance Difference: -11723, Match Status: Break, Discrepancy Category: Significant Discrepancy, Predicted Anomaly: Yes."
1,1618001,43892,96649,-52757,Break,Significant Discrepancy,1,"Company: 1, Account: 1618001, GL Balance: 43892, IHub Balance: 96649, Balance Difference: -52757, Match Status: Break, Discrepancy Category: Significant Discrepancy, Predicted Anomaly: Yes."
2,1618001,54674,95579,-40905,Break,Significant Discrepancy,1,"Company: 2, Account: 1618001, GL Balance: 54674, IHub Balance: 95579, Balance Difference: -40905, Match Status: Break, Discrepancy Category: Significant Discrepancy, Predicted Anomaly: Yes."
2,1618001,36754,55783,-19029,Break,Significant Discrepancy,1,"Company: 2, Account: 1618001, GL Balance: 36754, IHub Balance: 55783, Balance Difference: -19029, Match Status: Break, Discrepancy Category: Significant Discrepancy, Predicted Anomaly: Yes."
3,1618001,63632,24260,39372,Break,Significant Discrepancy,1,"Company: 3, Account: 1618001, GL Balance: 63632, IHub Balance: 24260, Balance Difference: 39372, Match Status: Break, Discrepancy Category: Significant Discrepancy, Predicted Anomaly: Yes."
3,1618001,37213,64555,-27342,Break,Significant Discrepancy,1,"Company: 3, Account: 1618001, GL Balance: 37213, IHub Balance: 64555, Balance Difference: -27342, Match Status: Break, Discrepancy Category: Significant Discrepancy, Predicted Anomaly: Yes."
2,1618001,15387,48619,-33232,Break,Significant Discrepancy,1,"Company: 2, Account: 1618001, GL Balance: 15387, IHub Balance: 48619, Balance Difference: -33232, Match Status: Break, Discrepancy Category: Significant Discrepancy, Predicted Anomaly: Yes."
2,1618001,53988,65797,-11809,Break,Significant Discrepancy,1,"Company: 2, Account: 1618001, GL Balance: 53988, IHub Balance: 65797, Balance Difference: -11809, Match Status: Break, Discrepancy Category: Significant Discrepancy, Predicted Anomaly: Yes."
3,1618001,57965,74595,-16630,Break,Significant Discrepancy,1,"Company: 3, Account: 1618001, GL Balance: 57965, IHub Balance: 74595, Balance Difference: -16630, Match Status: Break, Discrepancy Category: Significant Discrepancy, Predicted Anomaly: Yes."
2,1618001,53019,74591,-21572,Break,Significant Discrepancy,1,"Company: 2, Account: 1618001, GL Balance: 53019, IHub Balance: 74591, Balance Difference: -21572, Match Status: Break, Discrepancy Category: Significant Discrepancy, Predicted Anomaly: Yes."
3,1618001,50232,77850,-27618,Break,Significant Discrepancy,1,"Company: 3, Account: 1618001, GL Balance: 50232, IHub Balance: 77850, Balance Difference: -27618, Match Status: Break, Discrepancy Category: Significant Discrepancy, Predicted Anomaly: Yes."
3,1618001,35368,92912,-57544,Break,Significant Discrepancy,1,"Company: 3, Account: 1618001, GL Balance: 35368, IHub Balance: 92912, Balance Difference: -57544, Match Status: Break, Discrepancy Category: Significant Discrepancy, Predicted Anomaly: Yes."
3,1618001,89472,61016,28456,Break,Significant Discrepancy,1,"Company: 3, Account: 1618001, GL Balance: 89472, IHub Balance: 61016, Balance Difference: 28456, Match Status: Break, Discrepancy Category: Significant Discrepancy, Predicted Anomaly: Yes."
2,1618001,42161,45561,-3400,Break,Significant Discrepancy,1,"Company: 2, Account: 1618001, GL Balance: 42161, IHub Balance: 45561, Balance Difference: -3400, Match Status: Break, Discrepancy Category: Significant Discrepancy, Predicted Anomaly: Yes."
3,1618001,29544,67207,-37663,Break,Significant Discrepancy,1,"Company: 3, Account: 1618001, GL Balance: 29544, IHub Balance: 67207, Balance Difference: -37663, Match Status: Break, Discrepancy Category: Significant Discrepancy, Predicted Anomaly: Yes."
1,1618001,50931,83489,-32558,Break,Significant Discrepancy,1,"Company: 1, Account: 1618001, GL Balance: 50931, IHub Balance: 83489, Balance Difference: -32558, Match Status: Break, Discrepancy Category: Significant Discrepancy, Predicted Anomaly: Yes."
3,1618001,73155,18381,54774,Break,Significant Discrepancy,1,"Company: 3, Account: 1618001, GL Balance: 73155, IHub Balance: 18381, Balance Difference: 54774, Match Status: Break, Discrepancy Category: Significant Discrepancy, Predicted Anomaly: Yes."
3,1618001,51002,60624,-9622,Break,Significant Discrepancy,1,"Company: 3, Account: 1618001, GL Balance: 51002, IHub Balance: 60624, Balance Difference: -9622, Match Status: Break, Discrepancy Category: Significant Discrepancy, Predicted Anomaly: Yes."
3,1618001,28320,63664,-35344,Break,Significant Discrepancy,1,"Company: 3, Account: 1618001, GL Balance: 28320, IHub Balance: 63664, Balance Difference: -35344, Match Status: Break, Discrepancy Category: Significant Discrepancy, Predicted Anomaly: Yes."
2,1618001,75294,27682,47612,Break,Significant Discrepancy,1,"Company: 2, Account: 1618001, GL Balance: 75294, IHub Balance: 27682, Balance Difference: 47612, Match Status: Break, Discrepancy Category: Significant Discrepancy, Predicted Anomaly: Yes."
1,1618001,61977,22834,39143,Break,Significant Discrepancy,1,"Company: 1, Account: 1618001, GL Balance: 61977, IHub Balance: 22834, Balance Difference: 39143, Match Status: Break, Discrepancy Category: Significant Discrepancy, Predicted Anomaly: Yes."
1,1618001,81319,54458,26861,Break,Significant Discrepancy,1,"Company: 1, Account: 1618001, GL Balance: 81319, IHub Balance: 54458, Balance Difference: 26861, Match Status: Break, Discrepancy Category: Significant Discrepancy, Predicted Anomaly: Yes."
3,1618001,96784,46860,49924,Break,Significant Discrepancy,1,"Company: 3, Account: 1618001, GL Balance: 96784, IHub Balance: 46860, Balance Difference: 49924, Match Status: Break, Discrepancy Category: Significant Discrepancy, Predicted Anomaly: Yes."
2,1618001,19777,99941,-80164,Break,Significant Discrepancy,1,"Company: 2, Account: 1618001, GL Balance: 19777, IHub Balance: 99941, Balance Difference: -80164, Match Status: Break, Discrepancy Category: Significant Discrepancy, Predicted Anomaly: Yes."
1,1618001,79996,47743,32253,Break,Significant Discrepancy,1,"Company: 1, Account: 1618001, GL Balance: 79996, IHub Balance: 47743, Balance Difference: 32253, Match Status: Break, Discrepancy Category: Significant Discrepancy, Predicted Anomaly: Yes."
2,1618001,23450,71142,-47692,Break,Significant Discrepancy,1,"Company: 2, Account: 1618001, GL Balance: 23450, IHub Balance: 71142, Balance Difference: -47692, Match Status: Break, Discrepancy Category: Significant Discrepancy, Predicted Anomaly: Yes."
2,1618001,85312,63333,21979,Break,Significant Discrepancy,1,"Company: 2, Account: 1618001, GL Balance: 85312, IHub Balance: 63333, Balance Difference: 21979, Match Status: Break, Discrepancy Category: Significant Discrepancy, Predicted Anomaly: Yes."
3,1618001,59832,66911,-7079,Break,Significant Discrepancy,1,"Company: 3, Account: 1618001, GL Balance: 59832, IHub Balance: 66911, Balance Difference: -7079, Match Status: Break, Discrepancy Category: Significant Discrepancy, Predicted Anomaly: Yes."
1,1618001,44493,43270,1223,Break,Significant Discrepancy,1,"Company: 1, Account: 1618001, GL Balance: 44493, IHub Balance: 43270, Balance Difference: 1223, Match Status: Break, Discrepancy Category: Significant Discrepancy, Predicted Anomaly: Yes."
1,1618001,71607,67124,4483,Break,Significant Discrepancy,1,"Company: 1, Account: 1618001, GL Balance: 71607, IHub Balance: 67124, Balance Difference: 4483, Match Status: Break, Discrepancy Category: Significant Discrepancy, Predicted Anomaly: Yes."
2,1618001,13632,94153,-80521,Break,Significant Discrepancy,1,"Company: 2, Account: 1618001, GL Balance: 13632, IHub Balance: 94153, Balance Difference: -80521, Match Status: Break, Discrepancy Category: Significant Discrepancy, Predicted Anomaly: Yes."
2,1618001,74222,52036,22186,Break,Significant Discrepancy,1,"Company: 2, Account: 1618001, GL Balance: 74222, IHub Balance: 52036, Balance Difference: 22186, Match Status: Break, Discrepancy Category: Significant Discrepancy, Predicted Anomaly: Yes."
1,1618001,57928,36411,21517,Break,Significant Discrepancy,1,"Company: 1, Account: 1618001, GL Balance: 57928, IHub Balance: 36411, Balance Difference: 21517, Match Status: Break, Discrepancy Category: Significant Discrepancy, Predicted Anomaly: Yes."
2,1618001,47909,55167,-7258,Break,Significant Discrepancy,1,"Company: 2, Account: 1618001, GL Balance: 47909, IHub Balance: 55167, Balance Difference: -7258, Match Status: Break, Discrepancy Category: Significant Discrepancy, Predicted Anomaly: Yes."
2,1618001,71824,56069,15755,Break,Significant Discrepancy,1,"Company: 2, Account: 1618001, GL Balance: 71824, IHub Balance: 56069, Balance Difference: 15755, Match Status: Break, Discrepancy Category: Significant Discrepancy, Predicted Anomaly: Yes."
1,1618001,15190,63811,-48621,Break,Significant Discrepancy,1,"Company: 1, Account: 1618001, GL Balance: 15190, IHub Balance: 63811, Balance Difference: -48621, Match Status: Break, Discrepancy Category: Significant Discrepancy, Predicted Anomaly: Yes."
2,1618001,90618,63526,27092,Break,Significant Discrepancy,1,"Company: 2, Account: 1618001, GL Balance: 90618, IHub Balance: 63526, Balance Difference: 27092, Match Status: Break, Discrepancy Category: Significant Discrepancy, Predicted Anomaly: Yes."
3,1618001,74857,67320,7537,Break,Significant Discrepancy,1,"Company: 3, Account: 1618001, GL Balance: 74857, IHub Balance: 67320, Balance Difference: 7537, Match Status: Break, Discrepancy Category: Significant Discrepancy, Predicted Anomaly: Yes."
3,1618001,65872,85587,-19715,Break,Significant Discrepancy,1,"Company: 3, Account: 1618001, GL Balance: 65872, IHub Balance: 85587, Balance Difference: -19715, Match Status: Break, Discrepancy Category: Significant Discrepancy, Predicted Anomaly: Yes."
1,1618001,96590,96240,350,Match,Other,0,"Company: 1, Account: 1618001, GL Balance: 96590, IHub Balance: 96240, Balance Difference: 350, Match Status: Match, Discrepancy Category: Other, Predicted Anomaly: No."
1,1618001,91976,20778,71198,Break,Significant Discrepancy,1,"Company: 1, Account: 1618001, GL Balance: 91976, IHub Balance: 20778, Balance Difference: 71198, Match Status: Break, Discrepancy Category: Significant Discrepancy, Predicted Anomaly: Yes."
2,1618001,84495,32394,52101,Break,Significant Discrepancy,1,"Company: 2, Account: 1618001, GL Balance: 84495, IHub Balance: 32394, Balance Difference: 52101, Match Status: Break, Discrepancy Category: Significant Discrepancy, Predicted Anomaly: Yes."
2,1618001,83263,68830,14433,Break,Significant Discrepancy,1,"Company: 2, Account: 1618001, GL Balance: 83263, IHub Balance: 68830, Balance Difference: 14433, Match Status: Break, Discrepancy Category: Significant Discrepancy, Predicted Anomaly: Yes."
3,1618001,86675,26911,59764,Break,Significant Discrepancy,1,"Company: 3, Account: 1618001, GL Balance: 86675, IHub Balance: 26911, Balance Difference: 59764, Match Status: Break, Discrepancy Category: Significant Discrepancy, Predicted Anomaly: Yes."
1,1618001,99297,22288,77009,Break,Significant Discrepancy,1,"Company: 1, Account: 1618001, GL Balance: 99297, IHub Balance: 22288, Balance Difference: 77009, Match Status: Break, Discrepancy Category: Significant Discrepancy, Predicted Anomaly: Yes."
3,1618001,45167,29977,15190,Break,Significant Discrepancy,1,"Company: 3, Account: 1618001, GL Balance: 45167, IHub Balance: 29977, Balance Difference: 15190, Match Status: Break, Discrepancy Category: Significant Discrepancy, Predicted Anomaly: Yes."
1,1618001,95001,45036,49965,Break,Significant Discrepancy,1,"Company: 1, Account: 1618001, GL Balance: 95001, IHub Balance: 45036, Balance Difference: 49965, Match Status: Break, Discrepancy Category: Significant Discrepancy, Predicted Anomaly: Yes."
3,1618001,85271,72576,12695,Break,Significant Discrepancy,1,"Company: 3, Account: 1618001, GL Balance: 85271, IHub Balance: 72576, Balance Difference: 12695, Match Status: Break, Discrepancy Category: Significant Discrepancy, Predicted Anomaly: Yes."
1,1618001,56300,63546,-7246,Break,Significant Discrepancy,1,"Company: 1, Account: 1618001, GL Balance: 56300, IHub Balance: 63546, Balance Difference: -7246, Match Status: Break, Discrepancy Category: Significant Discrepancy, Predicted Anomaly: Yes."
2,1618001,89803,48725,41078,Break,Significant Discrepancy,1,"Company: 2, Account: 1618001, GL Balance: 89803, IHub Balance: 48725, Balance Difference: 41078, Match Status: Break, Discrepancy Category: Significant Discrepancy, Predicted Anomaly: Yes."
2,1618001,49749,61690,-11941,Break,Significant Discrepancy,1,"Company: 2, Account: 1618001, GL Balance: 49749, IHub Balance: 61690, Balance Difference: -11941, Match Status: Break, Discrepancy Category: Significant Discrepancy, Predicted Anomaly: Yes."
2,1618001,50958,66516,-15558,Break,Significant Discrepancy,1,"Company: 2, Account: 1618001, GL Balance: 50958, IHub Balance: 66516, Balance Difference: -15558, Match Status: Break, Discrepancy Category: Significant Discrepancy, Predicted Anomaly: Yes."
2,1618001,72363,41368,30995,Break,Significant Discrepancy,1,"Company: 2, Account: 1618001, GL Balance: 72363, IHub Balance: 41368, Balance Difference: 30995, Match Status: Break, Discrepancy Category: Significant Discrepancy, Predicted Anomaly: Yes."
1,1618001,59297,57993,1304,Break,Significant Discrepancy,1,"Company: 1, Account: 1618001, GL Balance: 59297, IHub Balance: 57993, Balance Difference: 1304, Match Status: Break, Discrepancy Category: Significant Discrepancy, Predicted Anomaly: Yes."
1,1618001,49963,13883,36080,Break,Significant Discrepancy,1,"Company: 1, Account: 1618001, GL Balance: 49963, IHub Balance: 13883, Balance Difference: 36080, Match Status: Break, Discrepancy Category: Significant Discrepancy, Predicted Anomaly: Yes."
3,1618001,19425,50794,-31369,Break,Significant Discrepancy,1,"Company: 3, Account: 1618001, GL Balance: 19425, IHub Balance: 50794, Balance Difference: -31369, Match Status: Break, Discrepancy Category: Significant Discrepancy, Predicted Anomaly: Yes."
3,1618001,48640,82420,-33780,Break,Significant Discrepancy,1,"Company: 3, Account: 1618001, GL Balance: 48640, IHub Balance: 82420, Balance Difference: -33780, Match Status: Break, Discrepancy Category: Significant Discrepancy, Predicted Anomaly: Yes."
1,1618001,93990,25185,68805,Break,Significant Discrepancy,1,"Company: 1, Account: 1618001, GL Balance: 93990, IHub Balance: 25185, Balance Difference: 68805, Match Status: Break, Discrepancy Category: Significant Discrepancy, Predicted Anomaly: Yes."
2,1618001,25916,37916,-12000,Break,Significant Discrepancy,1,"Company: 2, Account: 1618001, GL Balance: 25916, IHub Balance: 37916, Balance Difference: -12000, Match Status: Break, Discrepancy Category: Significant Discrepancy, Predicted Anomaly: Yes."
3,1618001,64213,58458,5755,Break,Significant Discrepancy,1,"Company: 3, Account: 1618001, GL Balance: 64213, IHub Balance: 58458, Balance Difference: 5755, Match Status: Break, Discrepancy Category: Significant Discrepancy, Predicted Anomaly: Yes."
3,1618001,52503,78259,-25756,Break,Significant Discrepancy,1,"Company: 3, Account: 1618001, GL Balance: 52503, IHub Balance: 78259, Balance Difference: -25756, Match Status: Break, Discrepancy Category: Significant Discrepancy, Predicted Anomaly: Yes."
1,1618001,42222,73690,-31468,Break,Significant Discrepancy,1,"Company: 1, Account: 1618001, GL Balance: 42222, IHub Balance: 73690, Balance Difference: -31468, Match Status: Break, Discrepancy Category: Significant Discrepancy, Predicted Anomaly: Yes."
2,1618001,71756,52215,19541,Break,Significant Discrepancy,1,"Company: 2, Account: 1618001, GL Balance: 71756, IHub Balance: 52215, Balance Difference: 19541, Match Status: Break, Discrepancy Category: Significant Discrepancy, Predicted Anomaly: Yes."
2,1618001,95184,11509,83675,Break,Significant Discrepancy,1,"Company: 2, Account: 1618001, GL Balance: 95184, IHub Balance: 11509, Balance Difference: 83675, Match Status: Break, Discrepancy Category: Significant Discrepancy, Predicted Anomaly: Yes."
1,1618001,21161,47656,-26495,Break,Significant Discrepancy,1,"Company: 1, Account: 1618001, GL Balance: 21161, IHub Balance: 47656, Balance Difference: -26495, Match Status: Break, Discrepancy Category: Significant Discrepancy, Predicted Anomaly: Yes."
1,1618001,27352,46948,-19596,Break,Significant Discrepancy,1,"Company: 1, Account: 1618001, GL Balance: 27352, IHub Balance: 46948, Balance Difference: -19596, Match Status: Break, Discrepancy Category: Significant Discrepancy, Predicted Anomaly: Yes."
1,1618001,13262,33671,-20409,Break,Significant Discrepancy,1,"Company: 1, Account: 1618001, GL Balance: 13262, IHub Balance: 33671, Balance Difference: -20409, Match Status: Break, Discrepancy Category: Significant Discrepancy, Predicted Anomaly: Yes."
2,1618001,97193,56707,40486,Break,Significant Discrepancy,1,"Company: 2, Account: 1618001, GL Balance: 97193, IHub Balance: 56707, Balance Difference: 40486, Match Status: Break, Discrepancy Category: Significant Discrepancy, Predicted Anomaly: Yes."
2,1618001,66131,83168,-17037,Break,Significant Discrepancy,1,"Company: 2, Account: 1618001, GL Balance: 66131, IHub Balance: 83168, Balance Difference: -17037, Match Status: Break, Discrepancy Category: Significant Discrepancy, Predicted Anomaly: Yes."
3,1618001,22856,10799,12057,Break,Significant Discrepancy,1,"Company: 3, Account: 1618001, GL Balance: 22856, IHub Balance: 10799, Balance Difference: 12057, Match Status: Break, Discrepancy Category: Significant Discrepancy, Predicted Anomaly: Yes."
2,1618001,71416,23908,47508,Break,Significant Discrepancy,1,"Company: 2, Account: 1618001, GL Balance: 71416, IHub Balance: 23908, Balance Difference: 47508, Match Status: Break, Discrepancy Category: Significant Discrepancy, Predicted Anomaly: Yes."
2,1618001,54813,79487,-24674,Break,Significant Discrepancy,1,"Company: 2, Account: 1618001, GL Balance: 54813, IHub Balance: 79487, Balance Difference: -24674, Match Status: Break, Discrepancy Category: Significant Discrepancy, Predicted Anomaly: Yes."
3,1618001,36872,37610,-738,Match,Other,0,"Company: 3, Account: 1618001, GL Balance: 36872, IHub Balance: 37610, Balance Difference: -738, Match Status: Match, Discrepancy Category: Other, Predicted Anomaly: No."
3,1618001,84391,51833,32558,Break,Significant Discrepancy,1,"Company: 3, Account: 1618001, GL Balance: 84391, IHub Balance: 51833, Balance Difference: 32558, Match Status: Break, Discrepancy Category: Significant Discrepancy, Predicted Anomaly: Yes."
1,1618001,32958,24635,8323,Break,Significant Discrepancy,1,"Company: 1, Account: 1618001, GL Balance: 32958, IHub Balance: 24635, Balance Difference: 8323, Match Status: Break, Discrepancy Category: Significant Discrepancy, Predicted Anomaly: Yes."
3,1618001,47066,46382,684,Match,Other,0,"Company: 3, Account: 1618001, GL Balance: 47066, IHub Balance: 46382, Balance Difference: 684, Match Status: Match, Discrepancy Category: Other, Predicted Anomaly: No."
2,1618001,75546,28402,47144,Break,Significant Discrepancy,1,"Company: 2, Account: 1618001, GL Balance: 75546, IHub Balance: 28402, Balance Difference: 47144, Match Status: Break, Discrepancy Category: Significant Discrepancy, Predicted Anomaly: Yes."
3,1618001,49373,77957,-28584,Break,Significant Discrepancy,1,"Company: 3, Account: 1618001, GL Balance: 49373, IHub Balance: 77957, Balance Difference: -28584, Match Status: Break, Discrepancy Category: Significant Discrepancy, Predicted Anomaly: Yes."
2,1618001,72537,46787,25750,Break,Significant Discrepancy,1,"Company: 2, Account: 1618001, GL Balance: 72537, IHub Balance: 46787, Balance Difference: 25750, Match Status: Break, Discrepancy Category: Significant Discrepancy, Predicted Anomaly: Yes."
3,1618001,10364,39405,-29041,Break,Significant Discrepancy,1,"Company: 3, Account: 1618001, GL Balance: 10364, IHub Balance: 39405, Balance Difference: -29041, Match Status: Break, Discrepancy Category: Significant Discrepancy, Predicted Anomaly: Yes."
3,1618001,19969,53094,-33125,Break,Significant Discrepancy,1,"Company: 3, Account: 1618001, GL Balance: 19969, IHub Balance: 53094, Balance Difference: -33125, Match Status: Break, Discrepancy Category: Significant Discrepancy, Predicted Anomaly: Yes."
2,1618001,79930,29515,50415,Break,Significant Discrepancy,1,"Company: 2, Account: 1618001, GL Balance: 79930, IHub Balance: 29515, Balance Difference: 50415, Match Status: Break, Discrepancy Category: Significant Discrepancy, Predicted Anomaly: Yes."
3,1618001,57078,36016,21062,Break,Significant Discrepancy,1,"Company: 3, Account: 1618001, GL Balance: 57078, IHub Balance: 36016, Balance Difference: 21062, Match Status: Break, Discrepancy Category: Significant Discrepancy, Predicted Anomaly: Yes."
1,1618001,14677,45518,-30841,Break,Significant Discrepancy,1,"Company: 1, Account: 1618001, GL Balance: 14677, IHub Balance: 45518, Balance Difference: -30841, Match Status: Break, Discrepancy Category: Significant Discrepancy, Predicted Anomaly: Yes."
2,1618001,85677,21219,64458,Break,Significant Discrepancy,1,"Company: 2, Account: 1618001, GL Balance: 85677, IHub Balance: 21219, Balance Difference: 64458, Match Status: Break, Discrepancy Category: Significant Discrepancy, Predicted Anomaly: Yes."
2,1618001,38439,16922,21517,Break,Significant Discrepancy,1,"Company: 2, Account: 1618001, GL Balance: 38439, IHub Balance: 16922, Balance Difference: 21517, Match Status: Break, Discrepancy Category: Significant Discrepancy, Predicted Anomaly: Yes."
3,1618001,52029,10296,41733,Break,Significant Discrepancy,1,"Company: 3, Account: 1618001, GL Balance: 52029, IHub Balance: 10296, Balance Difference: 41733, Match Status: Break, Discrepancy Category: Significant Discrepancy, Predicted Anomaly: Yes."
1,1618001,18837,61616,-42779,Break,Significant Discrepancy,1,"Company: 1, Account: 1618001, GL Balance: 18837, IHub Balance: 61616, Balance Difference: -42779, Match Status: Break, Discrepancy Category: Significant Discrepancy, Predicted Anomaly: Yes."
3,1618001,51420,10493,40927,Break,Significant Discrepancy,1,"Company: 3, Account: 1618001, GL Balance: 51420, IHub Balance: 10493, Balance Difference: 40927, Match Status: Break, Discrepancy Category: Significant Discrepancy, Predicted Anomaly: Yes."
2,1618001,31352,87779,-56427,Break,Significant Discrepancy,1,"Company: 2, Account: 1618001, GL Balance: 31352, IHub Balance: 87779, Balance Difference: -56427, Match Status: Break, Discrepancy Category: Significant Discrepancy, Predicted Anomaly: Yes."
3,1618001,94667,59047,35620,Break,Significant Discrepancy,1,"Company: 3, Account: 1618001, GL Balance: 94667, IHub Balance: 59047, Balance Difference: 35620, Match Status: Break, Discrepancy Category: Significant Discrepancy, Predicted Anomaly: Yes."
2,1618001,23934,78666,-54732,Break,Significant Discrepancy,1,"Company: 2, Account: 1618001, GL Balance: 23934, IHub Balance: 78666, Balance Difference: -54732, Match Status: Break, Discrepancy Category: Significant Discrepancy, Predicted Anomaly: Yes."
3,1618001,12801,24961,-12160,Break,Significant Discrepancy,1,"Company: 3, Account: 1618001, GL Balance: 12801, IHub Balance: 24961, Balance Difference: -12160, Match Status: Break, Discrepancy Category: Significant Discrepancy, Predicted Anomaly: Yes."
3,1618001,71521,52464,19057,Break,Significant Discrepancy,1,"Company: 3, Account: 1618001, GL Balance: 71521, IHub Balance: 52464, Balance Difference: 19057, Match Status: Break, Discrepancy Category: Significant Discrepancy, Predicted Anomaly: Yes."
2,1618001,88233,60110,28123,Break,Significant Discrepancy,1,"Company: 2, Account: 1618001, GL Balance: 88233, IHub Balance: 60110, Balance Difference: 28123, Match Status: Break, Discrepancy Category: Significant Discrepancy, Predicted Anomaly: Yes."
2,1618001,20082,66115,-46033,Break,Significant Discrepancy,1,"Company: 2, Account: 1618001, GL Balance: 20082, IHub Balance: 66115, Balance Difference: -46033, Match Status: Break, Discrepancy Category: Significant Discrepancy, Predicted Anomaly: Yes."
1,1618001,54999,77381,-22382,Break,Significant Discrepancy,1,"Company: 1, Account: 1618001, GL Balance: 54999, IHub Balance: 77381, Balance Difference: -22382, Match Status: Break, Discrepancy Category: Significant Discrepancy, Predicted Anomaly: Yes."
2,1618001,50081,94118,-44037,Break,Significant Discrepancy,1,"Company: 2, Account: 1618001, GL Balance: 50081, IHub Balance: 94118, Balance Difference: -44037, Match Status: Break, Discrepancy Category: Significant Discrepancy, Predicted Anomaly: Yes."
3,1618001,60903,77342,-16439,Break,Significant Discrepancy,1,"Company: 3, Account: 1618001, GL Balance: 60903, IHub Balance: 77342, Balance Difference: -16439, Match Status: Break, Discrepancy Category: Significant Discrepancy, Predicted Anomaly: Yes."
3,1618001,60575,66091,-5516,Break,Significant Discrepancy,1,"Company: 3, Account: 1618001, GL Balance: 60575, IHub Balance: 66091, Balance Difference: -5516, Match Status: Break, Discrepancy Category: Significant Discrepancy, Predicted Anomaly: Yes."
1,1618001,40984,95481,-54497,Break,Significant Discrepancy,1,"Company: 1, Account: 1618001, GL Balance: 40984, IHub Balance: 95481, Balance Difference: -54497, Match Status: Break, Discrepancy Category: Significant Discrepancy, Predicted Anomaly: Yes."
1,1618001,21319,87034,-65715,Break,Significant Discrepancy,1,"Company: 1, Account: 1618001, GL Balance: 21319, IHub Balance: 87034, Balance Difference: -65715, Match Status: Break, Discrepancy Category: Significant Discrepancy, Predicted Anomaly: Yes."
2,1618001,37624,41218,-3594,Break,Significant Discrepancy,1,"Company: 2, Account: 1618001, GL Balance: 37624, IHub Balance: 41218, Balance Difference: -3594, Match Status: Break, Discrepancy Category: Significant Discrepancy, Predicted Anomaly: Yes."
2,1618001,65006,59629,5377,Break,Significant Discrepancy,1,"Company: 2, Account: 1618001, GL Balance: 65006, IHub Balance: 59629, Balance Difference: 5377, Match Status: Break, Discrepancy Category: Significant Discrepancy, Predicted Anomaly: Yes."
3,1618001,71264,68241,3023,Break,Significant Discrepancy,1,"Company: 3, Account: 1618001, GL Balance: 71264, IHub Balance: 68241, Balance Difference: 3023, Match Status: Break, Discrepancy Category: Significant Discrepancy, Predicted Anomaly: Yes."
1,1618001,59395,32414,26981,Break,Significant Discrepancy,1,"Company: 1, Account: 1618001, GL Balance: 59395, IHub Balance: 32414, Balance Difference: 26981, Match Status: Break, Discrepancy Category: Significant Discrepancy, Predicted Anomaly: Yes."
3,1618001,97911,19677,78234,Break,Significant Discrepancy,1,"Company: 3, Account: 1618001, GL Balance: 97911, IHub Balance: 19677, Balance Difference: 78234, Match Status: Break, Discrepancy Category: Significant Discrepancy, Predicted Anomaly: Yes."
2,1618001,96753,33341,63412,Break,Significant Discrepancy,1,"Company: 2, Account: 1618001, GL Balance: 96753, IHub Balance: 33341, Balance Difference: 63412, Match Status: Break, Discrepancy Category: Significant Discrepancy, Predicted Anomaly: Yes."
1,1618001,45825,70313,-24488,Break,Significant Discrepancy,1,"Company: 1, Account: 1618001, GL Balance: 45825, IHub Balance: 70313, Balance Difference: -24488, Match Status: Break, Discrepancy Category: Significant Discrepancy, Predicted Anomaly: Yes."
1,1618001,37328,46135,-8807,Break,Significant Discrepancy,1,"Company: 1, Account: 1618001, GL Balance: 37328, IHub Balance: 46135, Balance Difference: -8807, Match Status: Break, Discrepancy Category: Significant Discrepancy, Predicted Anomaly: Yes."
1,1618001,38341,66361,-28020,Break,Significant Discrepancy,1,"Company: 1, Account: 1618001, GL Balance: 38341, IHub Balance: 66361, Balance Difference: -28020, Match Status: Break, Discrepancy Category: Significant Discrepancy, Predicted Anomaly: Yes."
1,1618001,81947,59177,22770,Break,Significant Discrepancy,1,"Company: 1, Account: 1618001, GL Balance: 81947, IHub Balance: 59177, Balance Difference: 22770, Match Status: Break, Discrepancy Category: Significant Discrepancy, Predicted Anomaly: Yes."
2,1618001,94360,24021,70339,Break,Significant Discrepancy,1,"Company: 2, Account: 1618001, GL Balance: 94360, IHub Balance: 24021, Balance Difference: 70339, Match Status: Break, Discrepancy Category: Significant Discrepancy, Predicted Anomaly: Yes."
3,1618001,83058,10684,72374,Break,Significant Discrepancy,1,"Company: 3, Account: 1618001, GL Balance: 83058, IHub Balance: 10684, Balance Difference: 72374, Match Status: Break, Discrepancy Category: Significant Discrepancy, Predicted Anomaly: Yes."
1,1618001,12402,34395,-21993,Break,Significant Discrepancy,1,"Company: 1, Account: 1618001, GL Balance: 12402, IHub Balance: 34395, Balance Difference: -21993, Match Status: Break, Discrepancy Category: Significant Discrepancy, Predicted Anomaly: Yes."
3,1618001,95038,39181,55857,Break,Significant Discrepancy,1,"Company: 3, Account: 1618001, GL Balance: 95038, IHub Balance: 39181, Balance Difference: 55857, Match Status: Break, Discrepancy Category: Significant Discrepancy, Predicted Anomaly: Yes."
2,1618001,42471,26766,15705,Break,Significant Discrepancy,1,"Company: 2, Account: 1618001, GL Balance: 42471, IHub Balance: 26766, Balance Difference: 15705, Match Status: Break, Discrepancy Category: Significant Discrepancy, Predicted Anomaly: Yes."
3,1618001,12431,85153,-72722,Break,Significant Discrepancy,1,"Company: 3, Account: 1618001, GL Balance: 12431, IHub Balance: 85153, Balance Difference: -72722, Match Status: Break, Discrepancy Category: Significant Discrepancy, Predicted Anomaly: Yes."
2,1618001,44743,91214,-46471,Break,Significant Discrepancy,1,"Company: 2, Account: 1618001, GL Balance: 44743, IHub Balance: 91214, Balance Difference: -46471, Match Status: Break, Discrepancy Category: Significant Discrepancy, Predicted Anomaly: Yes."
1,1618001,48097,77638,-29541,Break,Significant Discrepancy,1,"Company: 1, Account: 1618001, GL Balance: 48097, IHub Balance: 77638, Balance Difference: -29541, Match Status: Break, Discrepancy Category: Significant Discrepancy, Predicted Anomaly: Yes."
3,1618001,55615,85199,-29584,Break,Significant Discrepancy,1,"Company: 3, Account: 1618001, GL Balance: 55615, IHub Balance: 85199, Balance Difference: -29584, Match Status: Break, Discrepancy Category: Significant Discrepancy, Predicted Anomaly: Yes."
1,1618001,19921,43927,-24006,Break,Significant Discrepancy,1,"Company: 1, Account: 1618001, GL Balance: 19921, IHub Balance: 43927, Balance Difference: -24006, Match Status: Break, Discrepancy Category: Significant Discrepancy, Predicted Anomaly: Yes."
3,1618001,72222,37528,34694,Break,Significant Discrepancy,1,"Company: 3, Account: 1618001, GL Balance: 72222, IHub Balance: 37528, Balance Difference: 34694, Match Status: Break, Discrepancy Category: Significant Discrepancy, Predicted Anomaly: Yes."
1,1619000,98822,86095,12727,Break,Significant Discrepancy,1,"Company: 1, Account: 1619000, GL Balance: 98822, IHub Balance: 86095, Balance Difference: 12727, Match Status: Break, Discrepancy Category: Significant Discrepancy, Predicted Anomaly: Yes."
1,1619000,47134,90274,-43140,Break,Significant Discrepancy,1,"Company: 1, Account: 1619000, GL Balance: 47134, IHub Balance: 90274, Balance Difference: -43140, Match Status: Break, Discrepancy Category: Significant Discrepancy, Predicted Anomaly: Yes."
2,1619000,26105,17548,8557,Break,Significant Discrepancy,1,"Company: 2, Account: 1619000, GL Balance: 26105, IHub Balance: 17548, Balance Difference: 8557, Match Status: Break, Discrepancy Category: Significant Discrepancy, Predicted Anomaly: Yes."
1,1619000,65612,35825,29787,Break,Significant Discrepancy,1,"Company: 1, Account: 1619000, GL Balance: 65612, IHub Balance: 35825, Balance Difference: 29787, Match Status: Break, Discrepancy Category: Significant Discrepancy, Predicted Anomaly: Yes."
1,1619000,42275,62672,-20397,Break,Significant Discrepancy,1,"Company: 1, Account: 1619000, GL Balance: 42275, IHub Balance: 62672, Balance Difference: -20397, Match Status: Break, Discrepancy Category: Significant Discrepancy, Predicted Anomaly: Yes."
3,1619000,14922,64816,-49894,Break,Significant Discrepancy,1,"Company: 3, Account: 1619000, GL Balance: 14922, IHub Balance: 64816, Balance Difference: -49894, Match Status: Break, Discrepancy Category: Significant Discrepancy, Predicted Anomaly: Yes."
2,1619000,82227,92799,-10572,Break,Significant Discrepancy,1,"Company: 2, Account: 1619000, GL Balance: 82227, IHub Balance: 92799, Balance Difference: -10572, Match Status: Break, Discrepancy Category: Significant Discrepancy, Predicted Anomaly: Yes."
2,1619000,87400,14239,73161,Break,Significant Discrepancy,1,"Company: 2, Account: 1619000, GL Balance: 87400, IHub Balance: 14239, Balance Difference: 73161, Match Status: Break, Discrepancy Category: Significant Discrepancy, Predicted Anomaly: Yes."
1,1619000,10370,52718,-42348,Break,Significant Discrepancy,1,"Company: 1, Account: 1619000, GL Balance: 10370, IHub Balance: 52718, Balance Difference: -42348, Match Status: Break, Discrepancy Category: Significant Discrepancy, Predicted Anomaly: Yes."
3,1619000,98648,71918,26730,Break,Significant Discrepancy,1,"Company: 3, Account: 1619000, GL Balance: 98648, IHub Balance: 71918, Balance Difference: 26730, Match Status: Break, Discrepancy Category: Significant Discrepancy, Predicted Anomaly: Yes."
1,1619000,99614,94821,4793,Break,Significant Discrepancy,1,"Company: 1, Account: 1619000, GL Balance: 99614, IHub Balance: 94821, Balance Difference: 4793, Match Status: Break, Discrepancy Category: Significant Discrepancy, Predicted Anomaly: Yes."
2,1619000,34142,82089,-47947,Break,Significant Discrepancy,1,"Company: 2, Account: 1619000, GL Balance: 34142, IHub Balance: 82089, Balance Difference: -47947, Match Status: Break, Discrepancy Category: Significant Discrepancy, Predicted Anomaly: Yes."
3,1619000,68905,52322,16583,Break,Significant Discrepancy,1,"Company: 3, Account: 1619000, GL Balance: 68905, IHub Balance: 52322, Balance Difference: 16583, Match Status: Break, Discrepancy Category: Significant Discrepancy, Predicted Anomaly: Yes."
3,1619000,22818,89360,-66542,Break,Significant Discrepancy,1,"Company: 3, Account: 1619000, GL Balance: 22818, IHub Balance: 89360, Balance Difference: -66542, Match Status: Break, Discrepancy Category: Significant Discrepancy, Predicted Anomaly: Yes."
2,1619000,98444,25732,72712,Break,Significant Discrepancy,1,"Company: 2, Account: 1619000, GL Balance: 98444, IHub Balance: 25732, Balance Difference: 72712, Match Status: Break, Discrepancy Category: Significant Discrepancy, Predicted Anomaly: Yes."
1,1619000,92806,78422,14384,Break,Significant Discrepancy,1,"Company: 1, Account: 1619000, GL Balance: 92806, IHub Balance: 78422, Balance Difference: 14384, Match Status: Break, Discrepancy Category: Significant Discrepancy, Predicted Anomaly: Yes."
3,1619000,87199,88784,-1585,Break,Significant Discrepancy,1,"Company: 3, Account: 1619000, GL Balance: 87199, IHub Balance: 88784, Balance Difference: -1585, Match Status: Break, Discrepancy Category: Significant Discrepancy, Predicted Anomaly: Yes."
3,1619000,40408,60906,-20498,Break,Significant Discrepancy,1,"Company: 3, Account: 1619000, GL Balance: 40408, IHub Balance: 60906, Balance Difference: -20498, Match Status: Break, Discrepancy Category: Significant Discrepancy, Predicted Anomaly: Yes."
2,1619000,28976,14150,14826,Break,Significant Discrepancy,1,"Company: 2, Account: 1619000, GL Balance: 28976, IHub Balance: 14150, Balance Difference: 14826, Match Status: Break, Discrepancy Category: Significant Discrepancy, Predicted Anomaly: Yes."
2,1619000,72539,28526,44013,Break,Significant Discrepancy,1,"Company: 2, Account: 1619000, GL Balance: 72539, IHub Balance: 28526, Balance Difference: 44013, Match Status: Break, Discrepancy Category: Significant Discrepancy, Predicted Anomaly: Yes."
2,1619000,80793,69372,11421,Break,Significant Discrepancy,1,"Company: 2, Account: 1619000, GL Balance: 80793, IHub Balance: 69372, Balance Difference: 11421, Match Status: Break, Discrepancy Category: Significant Discrepancy, Predicted Anomaly: Yes."
3,1619000,39990,52321,-12331,Break,Significant Discrepancy,1,"Company: 3, Account: 1619000, GL Balance: 39990, IHub Balance: 52321, Balance Difference: -12331, Match Status: Break, Discrepancy Category: Significant Discrepancy, Predicted Anomaly: Yes."
3,1619000,97310,51476,45834,Break,Significant Discrepancy,1,"Company: 3, Account: 1619000, GL Balance: 97310, IHub Balance: 51476, Balance Difference: 45834, Match Status: Break, Discrepancy Category: Significant Discrepancy, Predicted Anomaly: Yes."
2,1619000,21600,56060,-34460,Break,Significant Discrepancy,1,"Company: 2, Account: 1619000, GL Balance: 21600, IHub Balance: 56060, Balance Difference: -34460, Match Status: Break, Discrepancy Category: Significant Discrepancy, Predicted Anomaly: Yes."
3,1619000,49534,48031,1503,Break,Significant Discrepancy,1,"Company: 3, Account: 1619000, GL Balance: 49534, IHub Balance: 48031, Balance Difference: 1503, Match Status: Break, Discrepancy Category: Significant Discrepancy, Predicted Anomaly: Yes."
3,1619000,98731,38460,60271,Break,Significant Discrepancy,1,"Company: 3, Account: 1619000, GL Balance: 98731, IHub Balance: 38460, Balance Difference: 60271, Match Status: Break, Discrepancy Category: Significant Discrepancy, Predicted Anomaly: Yes."
2,1619000,71716,76720,-5004,Break,Significant Discrepancy,1,"Company: 2, Account: 1619000, GL Balance: 71716, IHub Balance: 76720, Balance Difference: -5004, Match Status: Break, Discrepancy Category: Significant Discrepancy, Predicted Anomaly: Yes."
3,1619000,12963,46163,-33200,Break,Significant Discrepancy,1,"Company: 3, Account: 1619000, GL Balance: 12963, IHub Balance: 46163, Balance Difference: -33200, Match Status: Break, Discrepancy Category: Significant Discrepancy, Predicted Anomaly: Yes."
2,1619000,39902,89301,-49399,Break,Significant Discrepancy,1,"Company: 2, Account: 1619000, GL Balance: 39902, IHub Balance: 89301, Balance Difference: -49399, Match Status: Break, Discrepancy Category: Significant Discrepancy, Predicted Anomaly: Yes."
3,1619000,23866,75149,-51283,Break,Significant Discrepancy,1,"Company: 3, Account: 1619000, GL Balance: 23866, IHub Balance: 75149, Balance Difference: -51283, Match Status: Break, Discrepancy Category: Significant Discrepancy, Predicted Anomaly: Yes."
1,1619000,83757,62870,20887,Break,Significant Discrepancy,1,"Company: 1, Account: 1619000, GL Balance: 83757, IHub Balance: 62870, Balance Difference: 20887, Match Status: Break, Discrepancy Category: Significant Discrepancy, Predicted Anomaly: Yes."
1,1619000,72709,63934,8775,Break,Significant Discrepancy,1,"Company: 1, Account: 1619000, GL Balance: 72709, IHub Balance: 63934, Balance Difference: 8775, Match Status: Break, Discrepancy Category: Significant Discrepancy, Predicted Anomaly: Yes."
1,1619000,34124,87870,-53746,Break,Significant Discrepancy,1,"Company: 1, Account: 1619000, GL Balance: 34124, IHub Balance: 87870, Balance Difference: -53746, Match Status: Break, Discrepancy Category: Significant Discrepancy, Predicted Anomaly: Yes."
3,1619000,78047,36372,41675,Break,Significant Discrepancy,1,"Company: 3, Account: 1619000, GL Balance: 78047, IHub Balance: 36372, Balance Difference: 41675, Match Status: Break, Discrepancy Category: Significant Discrepancy, Predicted Anomaly: Yes."
3,1619000,58075,25700,32375,Break,Significant Discrepancy,1,"Company: 3, Account: 1619000, GL Balance: 58075, IHub Balance: 25700, Balance Difference: 32375, Match Status: Break, Discrepancy Category: Significant Discrepancy, Predicted Anomaly: Yes."
1,1619000,42872,92636,-49764,Break,Significant Discrepancy,1,"Company: 1, Account: 1619000, GL Balance: 42872, IHub Balance: 92636, Balance Difference: -49764, Match Status: Break, Discrepancy Category: Significant Discrepancy, Predicted Anomaly: Yes."
2,1619000,31514,84489,-52975,Break,Significant Discrepancy,1,"Company: 2, Account: 1619000, GL Balance: 31514, IHub Balance: 84489, Balance Difference: -52975, Match Status: Break, Discrepancy Category: Significant Discrepancy, Predicted Anomaly: Yes."
2,1619000,48179,30601,17578,Break,Significant Discrepancy,1,"Company: 2, Account: 1619000, GL Balance: 48179, IHub Balance: 30601, Balance Difference: 17578, Match Status: Break, Discrepancy Category: Significant Discrepancy, Predicted Anomaly: Yes."
3,1619000,17833,34074,-16241,Break,Significant Discrepancy,1,"Company: 3, Account: 1619000, GL Balance: 17833, IHub Balance: 34074, Balance Difference: -16241, Match Status: Break, Discrepancy Category: Significant Discrepancy, Predicted Anomaly: Yes."
3,1619000,73171,22419,50752,Break,Significant Discrepancy,1,"Company: 3, Account: 1619000, GL Balance: 73171, IHub Balance: 22419, Balance Difference: 50752, Match Status: Break, Discrepancy Category: Significant Discrepancy, Predicted Anomaly: Yes."
1,1619000,87947,63444,24503,Break,Significant Discrepancy,1,"Company: 1, Account: 1619000, GL Balance: 87947, IHub Balance: 63444, Balance Difference: 24503, Match Status: Break, Discrepancy Category: Significant Discrepancy, Predicted Anomaly: Yes."
1,1619000,77853,54772,23081,Break,Significant Discrepancy,1,"Company: 1, Account: 1619000, GL Balance: 77853, IHub Balance: 54772, Balance Difference: 23081, Match Status: Break, Discrepancy Category: Significant Discrepancy, Predicted Anomaly: Yes."
2,1619000,70148,90992,-20844,Break,Significant Discrepancy,1,"Company: 2, Account: 1619000, GL Balance: 70148, IHub Balance: 90992, Balance Difference: -20844, Match Status: Break, Discrepancy Category: Significant Discrepancy, Predicted Anomaly: Yes."
2,1619000,62335,72694,-10359,Break,Significant Discrepancy,1,"Company: 2, Account: 1619000, GL Balance: 62335, IHub Balance: 72694, Balance Difference: -10359, Match Status: Break, Discrepancy Category: Significant Discrepancy, Predicted Anomaly: Yes."
2,1619000,35017,82894,-47877,Break,Significant Discrepancy,1,"Company: 2, Account: 1619000, GL Balance: 35017, IHub Balance: 82894, Balance Difference: -47877, Match Status: Break, Discrepancy Category: Significant Discrepancy, Predicted Anomaly: Yes."
2,1619000,49994,17032,32962,Break,Significant Discrepancy,1,"Company: 2, Account: 1619000, GL Balance: 49994, IHub Balance: 17032, Balance Difference: 32962, Match Status: Break, Discrepancy Category: Significant Discrepancy, Predicted Anomaly: Yes."
1,1619000,98540,15914,82626,Break,Significant Discrepancy,1,"Company: 1, Account: 1619000, GL Balance: 98540, IHub Balance: 15914, Balance Difference: 82626, Match Status: Break, Discrepancy Category: Significant Discrepancy, Predicted Anomaly: Yes."
2,1619000,64273,11055,53218,Break,Significant Discrepancy,1,"Company: 2, Account: 1619000, GL Balance: 64273, IHub Balance: 11055, Balance Difference: 53218, Match Status: Break, Discrepancy Category: Significant Discrepancy, Predicted Anomaly: Yes."
1,1619000,23663,18007,5656,Break,Significant Discrepancy,1,"Company: 1, Account: 1619000, GL Balance: 23663, IHub Balance: 18007, Balance Difference: 5656, Match Status: Break, Discrepancy Category: Significant Discrepancy, Predicted Anomaly: Yes."
3,1619000,73190,28756,44434,Break,Significant Discrepancy,1,"Company: 3, Account: 1619000, GL Balance: 73190, IHub Balance: 28756, Balance Difference: 44434, Match Status: Break, Discrepancy Category: Significant Discrepancy, Predicted Anomaly: Yes."
2,1619000,78049,24481,53568,Break,Significant Discrepancy,1,"Company: 2, Account: 1619000, GL Balance: 78049, IHub Balance: 24481, Balance Difference: 53568, Match Status: Break, Discrepancy Category: Significant Discrepancy, Predicted Anomaly: Yes."
2,1619000,67175,58624,8551,Break,Significant Discrepancy,1,"Company: 2, Account: 1619000, GL Balance: 67175, IHub Balance: 58624, Balance Difference: 8551, Match Status: Break, Discrepancy Category: Significant Discrepancy, Predicted Anomaly: Yes."
1,1619000,44600,66194,-21594,Break,Significant Discrepancy,1,"Company: 1, Account: 1619000, GL Balance: 44600, IHub Balance: 66194, Balance Difference: -21594, Match Status: Break, Discrepancy Category: Significant Discrepancy, Predicted Anomaly: Yes."
3,1619000,17219,20715,-3496,Break,Significant Discrepancy,1,"Company: 3, Account: 1619000, GL Balance: 17219, IHub Balance: 20715, Balance Difference: -3496, Match Status: Break, Discrepancy Category: Significant Discrepancy, Predicted Anomaly: Yes."
1,1619000,63450,48492,14958,Break,Significant Discrepancy,1,"Company: 1, Account: 1619000, GL Balance: 63450, IHub Balance: 48492, Balance Difference: 14958, Match Status: Break, Discrepancy Category: Significant Discrepancy, Predicted Anomaly: Yes."
2,1619000,87470,30047,57423,Break,Significant Discrepancy,1,"Company: 2, Account: 1619000, GL Balance: 87470, IHub Balance: 30047, Balance Difference: 57423, Match Status: Break, Discrepancy Category: Significant Discrepancy, Predicted Anomaly: Yes."
2,1619000,10148,43414,-33266,Break,Significant Discrepancy,1,"Company: 2, Account: 1619000, GL Balance: 10148, IHub Balance: 43414, Balance Difference: -33266, Match Status: Break, Discrepancy Category: Significant Discrepancy, Predicted Anomaly: Yes."
2,1619000,25407,82936,-57529,Break,Significant Discrepancy,1,"Company: 2, Account: 1619000, GL Balance: 25407, IHub Balance: 82936, Balance Difference: -57529, Match Status: Break, Discrepancy Category: Significant Discrepancy, Predicted Anomaly: Yes."
2,1619000,44414,91007,-46593,Break,Significant Discrepancy,1,"Company: 2, Account: 1619000, GL Balance: 44414, IHub Balance: 91007, Balance Difference: -46593, Match Status: Break, Discrepancy Category: Significant Discrepancy, Predicted Anomaly: Yes."
2,1619000,10801,68051,-57250,Break,Significant Discrepancy,1,"Company: 2, Account: 1619000, GL Balance: 10801, IHub Balance: 68051, Balance Difference: -57250, Match Status: Break, Discrepancy Category: Significant Discrepancy, Predicted Anomaly: Yes."
1,1619000,87186,28157,59029,Break,Significant Discrepancy,1,"Company: 1, Account: 1619000, GL Balance: 87186, IHub Balance: 28157, Balance Difference: 59029, Match Status: Break, Discrepancy Category: Significant Discrepancy, Predicted Anomaly: Yes."
2,1619000,75629,68847,6782,Break,Significant Discrepancy,1,"Company: 2, Account: 1619000, GL Balance: 75629, IHub Balance: 68847, Balance Difference: 6782, Match Status: Break, Discrepancy Category: Significant Discrepancy, Predicted Anomaly: Yes."
3,1619000,40177,59907,-19730,Break,Significant Discrepancy,1,"Company: 3, Account: 1619000, GL Balance: 40177, IHub Balance: 59907, Balance Difference: -19730, Match Status: Break, Discrepancy Category: Significant Discrepancy, Predicted Anomaly: Yes."
1,1619000,74210,14482,59728,Break,Significant Discrepancy,1,"Company: 1, Account: 1619000, GL Balance: 74210, IHub Balance: 14482, Balance Difference: 59728, Match Status: Break, Discrepancy Category: Significant Discrepancy, Predicted Anomaly: Yes."
2,1619000,21009,64892,-43883,Break,Significant Discrepancy,1,"Company: 2, Account: 1619000, GL Balance: 21009, IHub Balance: 64892, Balance Difference: -43883, Match Status: Break, Discrepancy Category: Significant Discrepancy, Predicted Anomaly: Yes."
1,1619000,44207,45790,-1583,Break,Significant Discrepancy,1,"Company: 1, Account: 1619000, GL Balance: 44207, IHub Balance: 45790, Balance Difference: -1583, Match Status: Break, Discrepancy Category: Significant Discrepancy, Predicted Anomaly: Yes."
2,1619000,26406,39318,-12912,Break,Significant Discrepancy,1,"Company: 2, Account: 1619000, GL Balance: 26406, IHub Balance: 39318, Balance Difference: -12912, Match Status: Break, Discrepancy Category: Significant Discrepancy, Predicted Anomaly: Yes."
2,1619000,25261,18252,7009,Break,Significant Discrepancy,1,"Company: 2, Account: 1619000, GL Balance: 25261, IHub Balance: 18252, Balance Difference: 7009, Match Status: Break, Discrepancy Category: Significant Discrepancy, Predicted Anomaly: Yes."
1,1619000,19491,74373,-54882,Break,Significant Discrepancy,1,"Company: 1, Account: 1619000, GL Balance: 19491, IHub Balance: 74373, Balance Difference: -54882, Match Status: Break, Discrepancy Category: Significant Discrepancy, Predicted Anomaly: Yes."
2,1619000,41629,29522,12107,Break,Significant Discrepancy,1,"Company: 2, Account: 1619000, GL Balance: 41629, IHub Balance: 29522, Balance Difference: 12107, Match Status: Break, Discrepancy Category: Significant Discrepancy, Predicted Anomaly: Yes."
1,1619000,77560,12597,64963,Break,Significant Discrepancy,1,"Company: 1, Account: 1619000, GL Balance: 77560, IHub Balance: 12597, Balance Difference: 64963, Match Status: Break, Discrepancy Category: Significant Discrepancy, Predicted Anomaly: Yes."
3,1619000,65728,43440,22288,Break,Significant Discrepancy,1,"Company: 3, Account: 1619000, GL Balance: 65728, IHub Balance: 43440, Balance Difference: 22288, Match Status: Break, Discrepancy Category: Significant Discrepancy, Predicted Anomaly: Yes."
1,1619000,46912,78304,-31392,Break,Significant Discrepancy,1,"Company: 1, Account: 1619000, GL Balance: 46912, IHub Balance: 78304, Balance Difference: -31392, Match Status: Break, Discrepancy Category: Significant Discrepancy, Predicted Anomaly: Yes."
3,1619000,61805,66125,-4320,Break,Significant Discrepancy,1,"Company: 3, Account: 1619000, GL Balance: 61805, IHub Balance: 66125, Balance Difference: -4320, Match Status: Break, Discrepancy Category: Significant Discrepancy, Predicted Anomaly: Yes."
3,1619000,22638,79109,-56471,Break,Significant Discrepancy,1,"Company: 3, Account: 1619000, GL Balance: 22638, IHub Balance: 79109, Balance Difference: -56471, Match Status: Break, Discrepancy Category: Significant Discrepancy, Predicted Anomaly: Yes."
1,1619000,32948,78020,-45072,Break,Significant Discrepancy,1,"Company: 1, Account: 1619000, GL Balance: 32948, IHub Balance: 78020, Balance Difference: -45072, Match Status: Break, Discrepancy Category: Significant Discrepancy, Predicted Anomaly: Yes."
2,1619000,62300,65186,-2886,Break,Significant Discrepancy,1,"Company: 2, Account: 1619000, GL Balance: 62300, IHub Balance: 65186, Balance Difference: -2886, Match Status: Break, Discrepancy Category: Significant Discrepancy, Predicted Anomaly: Yes."
1,1619000,30874,83143,-52269,Break,Significant Discrepancy,1,"Company: 1, Account: 1619000, GL Balance: 30874, IHub Balance: 83143, Balance Difference: -52269, Match Status: Break, Discrepancy Category: Significant Discrepancy, Predicted Anomaly: Yes."
1,1619000,54990,89459,-34469,Break,Significant Discrepancy,1,"Company: 1, Account: 1619000, GL Balance: 54990, IHub Balance: 89459, Balance Difference: -34469, Match Status: Break, Discrepancy Category: Significant Discrepancy, Predicted Anomaly: Yes."
1,1619000,67632,65186,2446,Break,Significant Discrepancy,1,"Company: 1, Account: 1619000, GL Balance: 67632, IHub Balance: 65186, Balance Difference: 2446, Match Status: Break, Discrepancy Category: Significant Discrepancy, Predicted Anomaly: Yes."
1,1619000,72403,29476,42927,Break,Significant Discrepancy,1,"Company: 1, Account: 1619000, GL Balance: 72403, IHub Balance: 29476, Balance Difference: 42927, Match Status: Break, Discrepancy Category: Significant Discrepancy, Predicted Anomaly: Yes."
3,1619000,45524,48546,-3022,Break,Significant Discrepancy,1,"Company: 3, Account: 1619000, GL Balance: 45524, IHub Balance: 48546, Balance Difference: -3022, Match Status: Break, Discrepancy Category: Significant Discrepancy, Predicted Anomaly: Yes."
3,1619000,98921,71365,27556,Break,Significant Discrepancy,1,"Company: 3, Account: 1619000, GL Balance: 98921, IHub Balance: 71365, Balance Difference: 27556, Match Status: Break, Discrepancy Category: Significant Discrepancy, Predicted Anomaly: Yes."
3,1619000,59882,65107,-5225,Break,Significant Discrepancy,1,"Company: 3, Account: 1619000, GL Balance: 59882, IHub Balance: 65107, Balance Difference: -5225, Match Status: Break, Discrepancy Category: Significant Discrepancy, Predicted Anomaly: Yes."
2,1619000,43734,11986,31748,Break,Significant Discrepancy,1,"Company: 2, Account: 1619000, GL Balance: 43734, IHub Balance: 11986, Balance Difference: 31748, Match Status: Break, Discrepancy Category: Significant Discrepancy, Predicted Anomaly: Yes."
1,1619000,74839,32821,42018,Break,Significant Discrepancy,1,"Company: 1, Account: 1619000, GL Balance: 74839, IHub Balance: 32821, Balance Difference: 42018, Match Status: Break, Discrepancy Category: Significant Discrepancy, Predicted Anomaly: Yes."
1,1619000,38876,81939,-43063,Break,Significant Discrepancy,1,"Company: 1, Account: 1619000, GL Balance: 38876, IHub Balance: 81939, Balance Difference: -43063, Match Status: Break, Discrepancy Category: Significant Discrepancy, Predicted Anomaly: Yes."
2,1619000,84051,15947,68104,Break,Significant Discrepancy,1,"Company: 2, Account: 1619000, GL Balance: 84051, IHub Balance: 15947, Balance Difference: 68104, Match Status: Break, Discrepancy Category: Significant Discrepancy, Predicted Anomaly: Yes."
1,1619000,29569,71407,-41838,Break,Significant Discrepancy,1,"Company: 1, Account: 1619000, GL Balance: 29569, IHub Balance: 71407, Balance Difference: -41838, Match Status: Break, Discrepancy Category: Significant Discrepancy, Predicted Anomaly: Yes."
3,1619000,41113,21936,19177,Break,Significant Discrepancy,1,"Company: 3, Account: 1619000, GL Balance: 41113, IHub Balance: 21936, Balance Difference: 19177, Match Status: Break, Discrepancy Category: Significant Discrepancy, Predicted Anomaly: Yes."
3,1619000,66866,21109,45757,Break,Significant Discrepancy,1,"Company: 3, Account: 1619000, GL Balance: 66866, IHub Balance: 21109, Balance Difference: 45757, Match Status: Break, Discrepancy Category: Significant Discrepancy, Predicted Anomaly: Yes."
2,1619000,72182,95053,-22871,Break,Significant Discrepancy,1,"Company: 2, Account: 1619000, GL Balance: 72182, IHub Balance: 95053, Balance Difference: -22871, Match Status: Break, Discrepancy Category: Significant Discrepancy, Predicted Anomaly: Yes."
2,1619000,85133,82012,3121,Break,Significant Discrepancy,1,"Company: 2, Account: 1619000, GL Balance: 85133, IHub Balance: 82012, Balance Difference: 3121, Match Status: Break, Discrepancy Category: Significant Discrepancy, Predicted Anomaly: Yes."
1,1619000,22612,30895,-8283,Break,Significant Discrepancy,1,"Company: 1, Account: 1619000, GL Balance: 22612, IHub Balance: 30895, Balance Difference: -8283, Match Status: Break, Discrepancy Category: Significant Discrepancy, Predicted Anomaly: Yes."
1,1619000,54563,55278,-715,Match,Other,0,"Company: 1, Account: 1619000, GL Balance: 54563, IHub Balance: 55278, Balance Difference: -715, Match Status: Match, Discrepancy Category: Other, Predicted Anomaly: No."
1,1619000,26865,53554,-26689,Break,Significant Discrepancy,1,"Company: 1, Account: 1619000, GL Balance: 26865, IHub Balance: 53554, Balance Difference: -26689, Match Status: Break, Discrepancy Category: Significant Discrepancy, Predicted Anomaly: Yes."
2,1619000,88315,32923,55392,Break,Significant Discrepancy,1,"Company: 2, Account: 1619000, GL Balance: 88315, IHub Balance: 32923, Balance Difference: 55392, Match Status: Break, Discrepancy Category: Significant Discrepancy, Predicted Anomaly: Yes."
3,1619000,61310,11095,50215,Break,Significant Discrepancy,1,"Company: 3, Account: 1619000, GL Balance: 61310, IHub Balance: 11095, Balance Difference: 50215, Match Status: Break, Discrepancy Category: Significant Discrepancy, Predicted Anomaly: Yes."
3,1619000,50612,71756,-21144,Break,Significant Discrepancy,1,"Company: 3, Account: 1619000, GL Balance: 50612, IHub Balance: 71756, Balance Difference: -21144, Match Status: Break, Discrepancy Category: Significant Discrepancy, Predicted Anomaly: Yes."
2,1619000,93536,87256,6280,Break,Significant Discrepancy,1,"Company: 2, Account: 1619000, GL Balance: 93536, IHub Balance: 87256, Balance Difference: 6280, Match Status: Break, Discrepancy Category: Significant Discrepancy, Predicted Anomaly: Yes."
2,1619000,29551,48735,-19184,Break,Significant Discrepancy,1,"Company: 2, Account: 1619000, GL Balance: 29551, IHub Balance: 48735, Balance Difference: -19184, Match Status: Break, Discrepancy Category: Significant Discrepancy, Predicted Anomaly: Yes."
3,1619000,82258,74182,8076,Break,Significant Discrepancy,1,"Company: 3, Account: 1619000, GL Balance: 82258, IHub Balance: 74182, Balance Difference: 8076, Match Status: Break, Discrepancy Category: Significant Discrepancy, Predicted Anomaly: Yes."
3,1619000,94216,36962,57254,Break,Significant Discrepancy,1,"Company: 3, Account: 1619000, GL Balance: 94216, IHub Balance: 36962, Balance Difference: 57254, Match Status: Break, Discrepancy Category: Significant Discrepancy, Predicted Anomaly: Yes."
1,1619000,44112,50818,-6706,Break,Significant Discrepancy,1,"Company: 1, Account: 1619000, GL Balance: 44112, IHub Balance: 50818, Balance Difference: -6706, Match Status: Break, Discrepancy Category: Significant Discrepancy, Predicted Anomaly: Yes."
2,1619000,15912,38164,-22252,Break,Significant Discrepancy,1,"Company: 2, Account: 1619000, GL Balance: 15912, IHub Balance: 38164, Balance Difference: -22252, Match Status: Break, Discrepancy Category: Significant Discrepancy, Predicted Anomaly: Yes."
3,1619000,44332,16083,28249,Break,Significant Discrepancy,1,"Company: 3, Account: 1619000, GL Balance: 44332, IHub Balance: 16083, Balance Difference: 28249, Match Status: Break, Discrepancy Category: Significant Discrepancy, Predicted Anomaly: Yes."
3,1619000,67654,96038,-28384,Break,Significant Discrepancy,1,"Company: 3, Account: 1619000, GL Balance: 67654, IHub Balance: 96038, Balance Difference: -28384, Match Status: Break, Discrepancy Category: Significant Discrepancy, Predicted Anomaly: Yes."
3,1619000,31274,97897,-66623,Break,Significant Discrepancy,1,"Company: 3, Account: 1619000, GL Balance: 31274, IHub Balance: 97897, Balance Difference: -66623, Match Status: Break, Discrepancy Category: Significant Discrepancy, Predicted Anomaly: Yes."
1,1619000,83741,29689,54052,Break,Significant Discrepancy,1,"Company: 1, Account: 1619000, GL Balance: 83741, IHub Balance: 29689, Balance Difference: 54052, Match Status: Break, Discrepancy Category: Significant Discrepancy, Predicted Anomaly: Yes."
2,1619000,72784,90981,-18197,Break,Significant Discrepancy,1,"Company: 2, Account: 1619000, GL Balance: 72784, IHub Balance: 90981, Balance Difference: -18197, Match Status: Break, Discrepancy Category: Significant Discrepancy, Predicted Anomaly: Yes."
1,1619000,63911,26571,37340,Break,Significant Discrepancy,1,"Company: 1, Account: 1619000, GL Balance: 63911, IHub Balance: 26571, Balance Difference: 37340, Match Status: Break, Discrepancy Category: Significant Discrepancy, Predicted Anomaly: Yes."
3,1619000,54135,86095,-31960,Break,Significant Discrepancy,1,"Company: 3, Account: 1619000, GL Balance: 54135, IHub Balance: 86095, Balance Difference: -31960, Match Status: Break, Discrepancy Category: Significant Discrepancy, Predicted Anomaly: Yes."
1,1619000,89422,39717,49705,Break,Significant Discrepancy,1,"Company: 1, Account: 1619000, GL Balance: 89422, IHub Balance: 39717, Balance Difference: 49705, Match Status: Break, Discrepancy Category: Significant Discrepancy, Predicted Anomaly: Yes."
3,1619000,71779,37115,34664,Break,Significant Discrepancy,1,"Company: 3, Account: 1619000, GL Balance: 71779, IHub Balance: 37115, Balance Difference: 34664, Match Status: Break, Discrepancy Category: Significant Discrepancy, Predicted Anomaly: Yes."
1,1619000,22884,49236,-26352,Break,Significant Discrepancy,1,"Company: 1, Account: 1619000, GL Balance: 22884, IHub Balance: 49236, Balance Difference: -26352, Match Status: Break, Discrepancy Category: Significant Discrepancy, Predicted Anomaly: Yes."
3,1619000,25893,12176,13717,Break,Significant Discrepancy,1,"Company: 3, Account: 1619000, GL Balance: 25893, IHub Balance: 12176, Balance Difference: 13717, Match Status: Break, Discrepancy Category: Significant Discrepancy, Predicted Anomaly: Yes."
1,1619000,23444,56728,-33284,Break,Significant Discrepancy,1,"Company: 1, Account: 1619000, GL Balance: 23444, IHub Balance: 56728, Balance Difference: -33284, Match Status: Break, Discrepancy Category: Significant Discrepancy, Predicted Anomaly: Yes."
1,1619000,17436,56553,-39117,Break,Significant Discrepancy,1,"Company: 1, Account: 1619000, GL Balance: 17436, IHub Balance: 56553, Balance Difference: -39117, Match Status: Break, Discrepancy Category: Significant Discrepancy, Predicted Anomaly: Yes."
1,1619000,38314,50136,-11822,Break,Significant Discrepancy,1,"Company: 1, Account: 1619000, GL Balance: 38314, IHub Balance: 50136, Balance Difference: -11822, Match Status: Break, Discrepancy Category: Significant Discrepancy, Predicted Anomaly: Yes."
1,1619000,79754,12670,67084,Break,Significant Discrepancy,1,"Company: 1, Account: 1619000, GL Balance: 79754, IHub Balance: 12670, Balance Difference: 67084, Match Status: Break, Discrepancy Category: Significant Discrepancy, Predicted Anomaly: Yes."
3,1619000,92215,19638,72577,Break,Significant Discrepancy,1,"Company: 3, Account: 1619000, GL Balance: 92215, IHub Balance: 19638, Balance Difference: 72577, Match Status: Break, Discrepancy Category: Significant Discrepancy, Predicted Anomaly: Yes."
3,1619000,76354,94932,-18578,Break,Significant Discrepancy,1,"Company: 3, Account: 1619000, GL Balance: 76354, IHub Balance: 94932, Balance Difference: -18578, Match Status: Break, Discrepancy Category: Significant Discrepancy, Predicted Anomaly: Yes."
2,1619000,84408,52678,31730,Break,Significant Discrepancy,1,"Company: 2, Account: 1619000, GL Balance: 84408, IHub Balance: 52678, Balance Difference: 31730, Match Status: Break, Discrepancy Category: Significant Discrepancy, Predicted Anomaly: Yes."
3,1619000,83535,35854,47681,Break,Significant Discrepancy,1,"Company: 3, Account: 1619000, GL Balance: 83535, IHub Balance: 35854, Balance Difference: 47681, Match Status: Break, Discrepancy Category: Significant Discrepancy, Predicted Anomaly: Yes."
2,1619000,52733,14311,38422,Break,Significant Discrepancy,1,"Company: 2, Account: 1619000, GL Balance: 52733, IHub Balance: 14311, Balance Difference: 38422, Match Status: Break, Discrepancy Category: Significant Discrepancy, Predicted Anomaly: Yes."
3,1619000,31534,14023,17511,Break,Significant Discrepancy,1,"Company: 3, Account: 1619000, GL Balance: 31534, IHub Balance: 14023, Balance Difference: 17511, Match Status: Break, Discrepancy Category: Significant Discrepancy, Predicted Anomaly: Yes."
1,1619000,64545,19777,44768,Break,Significant Discrepancy,1,"Company: 1, Account: 1619000, GL Balance: 64545, IHub Balance: 19777, Balance Difference: 44768, Match Status: Break, Discrepancy Category: Significant Discrepancy, Predicted Anomaly: Yes."
1,1619000,96268,49218,47050,Break,Significant Discrepancy,1,"Company: 1, Account: 1619000, GL Balance: 96268, IHub Balance: 49218, Balance Difference: 47050, Match Status: Break, Discrepancy Category: Significant Discrepancy, Predicted Anomaly: Yes."
2,1619000,26304,46331,-20027,Break,Significant Discrepancy,1,"Company: 2, Account: 1619000, GL Balance: 26304, IHub Balance: 46331, Balance Difference: -20027, Match Status: Break, Discrepancy Category: Significant Discrepancy, Predicted Anomaly: Yes."
1,1619000,64951,47905,17046,Break,Significant Discrepancy,1,"Company: 1, Account: 1619000, GL Balance: 64951, IHub Balance: 47905, Balance Difference: 17046, Match Status: Break, Discrepancy Category: Significant Discrepancy, Predicted Anomaly: Yes."
2,1619000,40697,77445,-36748,Break,Significant Discrepancy,1,"Company: 2, Account: 1619000, GL Balance: 40697, IHub Balance: 77445, Balance Difference: -36748, Match Status: Break, Discrepancy Category: Significant Discrepancy, Predicted Anomaly: Yes."
2,1619000,72008,49767,22241,Break,Significant Discrepancy,1,"Company: 2, Account: 1619000, GL Balance: 72008, IHub Balance: 49767, Balance Difference: 22241, Match Status: Break, Discrepancy Category: Significant Discrepancy, Predicted Anomaly: Yes."
2,1619000,80641,17025,63616,Break,Significant Discrepancy,1,"Company: 2, Account: 1619000, GL Balance: 80641, IHub Balance: 17025, Balance Difference: 63616, Match Status: Break, Discrepancy Category: Significant Discrepancy, Predicted Anomaly: Yes."
1,1619000,85117,15255,69862,Break,Significant Discrepancy,1,"Company: 1, Account: 1619000, GL Balance: 85117, IHub Balance: 15255, Balance Difference: 69862, Match Status: Break, Discrepancy Category: Significant Discrepancy, Predicted Anomaly: Yes."
3,1619000,12956,86621,-73665,Break,Significant Discrepancy,1,"Company: 3, Account: 1619000, GL Balance: 12956, IHub Balance: 86621, Balance Difference: -73665, Match Status: Break, Discrepancy Category: Significant Discrepancy, Predicted Anomaly: Yes."
3,1619000,17939,28296,-10357,Break,Significant Discrepancy,1,"Company: 3, Account: 1619000, GL Balance: 17939, IHub Balance: 28296, Balance Difference: -10357, Match Status: Break, Discrepancy Category: Significant Discrepancy, Predicted Anomaly: Yes."
2,1619000,38182,76333,-38151,Break,Significant Discrepancy,1,"Company: 2, Account: 1619000, GL Balance: 38182, IHub Balance: 76333, Balance Difference: -38151, Match Status: Break, Discrepancy Category: Significant Discrepancy, Predicted Anomaly: Yes."
2,1619000,89360,78226,11134,Break,Significant Discrepancy,1,"Company: 2, Account: 1619000, GL Balance: 89360, IHub Balance: 78226, Balance Difference: 11134, Match Status: Break, Discrepancy Category: Significant Discrepancy, Predicted Anomaly: Yes."
2,1619000,89064,63084,25980,Break,Significant Discrepancy,1,"Company: 2, Account: 1619000, GL Balance: 89064, IHub Balance: 63084, Balance Difference: 25980, Match Status: Break, Discrepancy Category: Significant Discrepancy, Predicted Anomaly: Yes."
1,1619000,48452,87442,-38990,Break,Significant Discrepancy,1,"Company: 1, Account: 1619000, GL Balance: 48452, IHub Balance: 87442, Balance Difference: -38990, Match Status: Break, Discrepancy Category: Significant Discrepancy, Predicted Anomaly: Yes."
1,1619000,69072,44622,24450,Break,Significant Discrepancy,1,"Company: 1, Account: 1619000, GL Balance: 69072, IHub Balance: 44622, Balance Difference: 24450, Match Status: Break, Discrepancy Category: Significant Discrepancy, Predicted Anomaly: Yes."
1,1619000,78711,21292,57419,Break,Significant Discrepancy,1,"Company: 1, Account: 1619000, GL Balance: 78711, IHub Balance: 21292, Balance Difference: 57419, Match Status: Break, Discrepancy Category: Significant Discrepancy, Predicted Anomaly: Yes."
2,1619000,82943,54464,28479,Break,Significant Discrepancy,1,"Company: 2, Account: 1619000, GL Balance: 82943, IHub Balance: 54464, Balance Difference: 28479, Match Status: Break, Discrepancy Category: Significant Discrepancy, Predicted Anomaly: Yes."
2,1619000,99110,80515,18595,Break,Significant Discrepancy,1,"Company: 2, Account: 1619000, GL Balance: 99110, IHub Balance: 80515, Balance Difference: 18595, Match Status: Break, Discrepancy Category: Significant Discrepancy, Predicted Anomaly: Yes."
2,1619000,55784,60613,-4829,Break,Significant Discrepancy,1,"Company: 2, Account: 1619000, GL Balance: 55784, IHub Balance: 60613, Balance Difference: -4829, Match Status: Break, Discrepancy Category: Significant Discrepancy, Predicted Anomaly: Yes."
1,1619000,88627,72409,16218,Break,Significant Discrepancy,1,"Company: 1, Account: 1619000, GL Balance: 88627, IHub Balance: 72409, Balance Difference: 16218, Match Status: Break, Discrepancy Category: Significant Discrepancy, Predicted Anomaly: Yes."
1,1619000,80027,73832,6195,Break,Significant Discrepancy,1,"Company: 1, Account: 1619000, GL Balance: 80027, IHub Balance: 73832, Balance Difference: 6195, Match Status: Break, Discrepancy Category: Significant Discrepancy, Predicted Anomaly: Yes."
3,1619000,91782,53744,38038,Break,Significant Discrepancy,1,"Company: 3, Account: 1619000, GL Balance: 91782, IHub Balance: 53744, Balance Difference: 38038, Match Status: Break, Discrepancy Category: Significant Discrepancy, Predicted Anomaly: Yes."
2,1619000,97154,37657,59497,Break,Significant Discrepancy,1,"Company: 2, Account: 1619000, GL Balance: 97154, IHub Balance: 37657, Balance Difference: 59497, Match Status: Break, Discrepancy Category: Significant Discrepancy, Predicted Anomaly: Yes."
3,1619000,74610,87518,-12908,Break,Significant Discrepancy,1,"Company: 3, Account: 1619000, GL Balance: 74610, IHub Balance: 87518, Balance Difference: -12908, Match Status: Break, Discrepancy Category: Significant Discrepancy, Predicted Anomaly: Yes."
1,1619000,84907,56835,28072,Break,Significant Discrepancy,1,"Company: 1, Account: 1619000, GL Balance: 84907, IHub Balance: 56835, Balance Difference: 28072, Match Status: Break, Discrepancy Category: Significant Discrepancy, Predicted Anomaly: Yes."
2,1619000,97459,27158,70301,Break,Significant Discrepancy,1,"Company: 2, Account: 1619000, GL Balance: 97459, IHub Balance: 27158, Balance Difference: 70301, Match Status: Break, Discrepancy Category: Significant Discrepancy, Predicted Anomaly: Yes."
1,1619000,76188,24780,51408,Break,Significant Discrepancy,1,"Company: 1, Account: 1619000, GL Balance: 76188, IHub Balance: 24780, Balance Difference: 51408, Match Status: Break, Discrepancy Category: Significant Discrepancy, Predicted Anomaly: Yes."
3,1619000,70645,24439,46206,Break,Significant Discrepancy,1,"Company: 3, Account: 1619000, GL Balance: 70645, IHub Balance: 24439, Balance Difference: 46206, Match Status: Break, Discrepancy Category: Significant Discrepancy, Predicted Anomaly: Yes."
2,1619000,79847,69949,9898,Break,Significant Discrepancy,1,"Company: 2, Account: 1619000, GL Balance: 79847, IHub Balance: 69949, Balance Difference: 9898, Match Status: Break, Discrepancy Category: Significant Discrepancy, Predicted Anomaly: Yes."
1,1619000,94105,53151,40954,Break,Significant Discrepancy,1,"Company: 1, Account: 1619000, GL Balance: 94105, IHub Balance: 53151, Balance Difference: 40954, Match Status: Break, Discrepancy Category: Significant Discrepancy, Predicted Anomaly: Yes."
3,1619000,24728,43001,-18273,Break,Significant Discrepancy,1,"Company: 3, Account: 1619000, GL Balance: 24728, IHub Balance: 43001, Balance Difference: -18273, Match Status: Break, Discrepancy Category: Significant Discrepancy, Predicted Anomaly: Yes."
1,1619000,17689,46735,-29046,Break,Significant Discrepancy,1,"Company: 1, Account: 1619000, GL Balance: 17689, IHub Balance: 46735, Balance Difference: -29046, Match Status: Break, Discrepancy Category: Significant Discrepancy, Predicted Anomaly: Yes."
2,1619000,75548,46427,29121,Break,Significant Discrepancy,1,"Company: 2, Account: 1619000, GL Balance: 75548, IHub Balance: 46427, Balance Difference: 29121, Match Status: Break, Discrepancy Category: Significant Discrepancy, Predicted Anomaly: Yes."
3,1619000,42328,82728,-40400,Break,Significant Discrepancy,1,"Company: 3, Account: 1619000, GL Balance: 42328, IHub Balance: 82728, Balance Difference: -40400, Match Status: Break, Discrepancy Category: Significant Discrepancy, Predicted Anomaly: Yes."
2,1619000,77643,37167,40476,Break,Significant Discrepancy,1,"Company: 2, Account: 1619000, GL Balance: 77643, IHub Balance: 37167, Balance Difference: 40476, Match Status: Break, Discrepancy Category: Significant Discrepancy, Predicted Anomaly: Yes."
2,1619000,11379,25926,-14547,Break,Significant Discrepancy,1,"Company: 2, Account: 1619000, GL Balance: 11379, IHub Balance: 25926, Balance Difference: -14547, Match Status: Break, Discrepancy Category: Significant Discrepancy, Predicted Anomaly: Yes."
3,1619000,45135,63836,-18701,Break,Significant Discrepancy,1,"Company: 3, Account: 1619000, GL Balance: 45135, IHub Balance: 63836, Balance Difference: -18701, Match Status: Break, Discrepancy Category: Significant Discrepancy, Predicted Anomaly: Yes."
2,1619000,59932,98593,-38661,Break,Significant Discrepancy,1,"Company: 2, Account: 1619000, GL Balance: 59932, IHub Balance: 98593, Balance Difference: -38661, Match Status: Break, Discrepancy Category: Significant Discrepancy, Predicted Anomaly: Yes."
3,1619000,11754,96576,-84822,Break,Significant Discrepancy,1,"Company: 3, Account: 1619000, GL Balance: 11754, IHub Balance: 96576, Balance Difference: -84822, Match Status: Break, Discrepancy Category: Significant Discrepancy, Predicted Anomaly: Yes."
2,1619000,69896,95677,-25781,Break,Significant Discrepancy,1,"Company: 2, Account: 1619000, GL Balance: 69896, IHub Balance: 95677, Balance Difference: -25781, Match Status: Break, Discrepancy Category: Significant Discrepancy, Predicted Anomaly: Yes."
1,1619000,85930,99859,-13929,Break,Significant Discrepancy,1,"Company: 1, Account: 1619000, GL Balance: 85930, IHub Balance: 99859, Balance Difference: -13929, Match Status: Break, Discrepancy Category: Significant Discrepancy, Predicted Anomaly: Yes."
3,1619000,67920,16026,51894,Break,Significant Discrepancy,1,"Company: 3, Account: 1619000, GL Balance: 67920, IHub Balance: 16026, Balance Difference: 51894, Match Status: Break, Discrepancy Category: Significant Discrepancy, Predicted Anomaly: Yes."
2,1619000,40615,27273,13342,Break,Significant Discrepancy,1,"Company: 2, Account: 1619000, GL Balance: 40615, IHub Balance: 27273, Balance Difference: 13342, Match Status: Break, Discrepancy Category: Significant Discrepancy, Predicted Anomaly: Yes."
2,1619000,26493,94258,-67765,Break,Significant Discrepancy,1,"Company: 2, Account: 1619000, GL Balance: 26493, IHub Balance: 94258, Balance Difference: -67765, Match Status: Break, Discrepancy Category: Significant Discrepancy, Predicted Anomaly: Yes."
1,1619000,90879,93038,-2159,Break,Significant Discrepancy,1,"Company: 1, Account: 1619000, GL Balance: 90879, IHub Balance: 93038, Balance Difference: -2159, Match Status: Break, Discrepancy Category: Significant Discrepancy, Predicted Anomaly: Yes."
3,1619000,98116,93583,4533,Break,Significant Discrepancy,1,"Company: 3, Account: 1619000, GL Balance: 98116, IHub Balance: 93583, Balance Difference: 4533, Match Status: Break, Discrepancy Category: Significant Discrepancy, Predicted Anomaly: Yes."
1,1619000,92227,42430,49797,Break,Significant Discrepancy,1,"Company: 1, Account: 1619000, GL Balance: 92227, IHub Balance: 42430, Balance Difference: 49797, Match Status: Break, Discrepancy Category: Significant Discrepancy, Predicted Anomaly: Yes."
3,1619000,44470,72502,-28032,Break,Significant Discrepancy,1,"Company: 3, Account: 1619000, GL Balance: 44470, IHub Balance: 72502, Balance Difference: -28032, Match Status: Break, Discrepancy Category: Significant Discrepancy, Predicted Anomaly: Yes."
3,1619000,18077,60044,-41967,Break,Significant Discrepancy,1,"Company: 3, Account: 1619000, GL Balance: 18077, IHub Balance: 60044, Balance Difference: -41967, Match Status: Break, Discrepancy Category: Significant Discrepancy, Predicted Anomaly: Yes."
1,1619000,29642,49322,-19680,Break,Significant Discrepancy,1,"Company: 1, Account: 1619000, GL Balance: 29642, IHub Balance: 49322, Balance Difference: -19680, Match Status: Break, Discrepancy Category: Significant Discrepancy, Predicted Anomaly: Yes."
1,1619000,94766,96695,-1929,Break,Significant Discrepancy,1,"Company: 1, Account: 1619000, GL Balance: 94766, IHub Balance: 96695, Balance Difference: -1929, Match Status: Break, Discrepancy Category: Significant Discrepancy, Predicted Anomaly: Yes."
1,1619000,14507,97212,-82705,Break,Significant Discrepancy,1,"Company: 1, Account: 1619000, GL Balance: 14507, IHub Balance: 97212, Balance Difference: -82705, Match Status: Break, Discrepancy Category: Significant Discrepancy, Predicted Anomaly: Yes."
3,1619000,64238,24691,39547,Break,Significant Discrepancy,1,"Company: 3, Account: 1619000, GL Balance: 64238, IHub Balance: 24691, Balance Difference: 39547, Match Status: Break, Discrepancy Category: Significant Discrepancy, Predicted Anomaly: Yes."
1,1619000,20794,89305,-68511,Break,Significant Discrepancy,1,"Company: 1, Account: 1619000, GL Balance: 20794, IHub Balance: 89305, Balance Difference: -68511, Match Status: Break, Discrepancy Category: Significant Discrepancy, Predicted Anomaly: Yes."
2,1619000,88182,35218,52964,Break,Significant Discrepancy,1,"Company: 2, Account: 1619000, GL Balance: 88182, IHub Balance: 35218, Balance Difference: 52964, Match Status: Break, Discrepancy Category: Significant Discrepancy, Predicted Anomaly: Yes."
2,1619000,55647,65401,-9754,Break,Significant Discrepancy,1,"Company: 2, Account: 1619000, GL Balance: 55647, IHub Balance: 65401, Balance Difference: -9754, Match Status: Break, Discrepancy Category: Significant Discrepancy, Predicted Anomaly: Yes."
2,1619000,71305,60818,10487,Break,Significant Discrepancy,1,"Company: 2, Account: 1619000, GL Balance: 71305, IHub Balance: 60818, Balance Difference: 10487, Match Status: Break, Discrepancy Category: Significant Discrepancy, Predicted Anomaly: Yes."
3,1619000,53013,80467,-27454,Break,Significant Discrepancy,1,"Company: 3, Account: 1619000, GL Balance: 53013, IHub Balance: 80467, Balance Difference: -27454, Match Status: Break, Discrepancy Category: Significant Discrepancy, Predicted Anomaly: Yes."
2,1619000,91238,69052,22186,Break,Significant Discrepancy,1,"Company: 2, Account: 1619000, GL Balance: 91238, IHub Balance: 69052, Balance Difference: 22186, Match Status: Break, Discrepancy Category: Significant Discrepancy, Predicted Anomaly: Yes."
1,1619000,29239,79180,-49941,Break,Significant Discrepancy,1,"Company: 1, Account: 1619000, GL Balance: 29239, IHub Balance: 79180, Balance Difference: -49941, Match Status: Break, Discrepancy Category: Significant Discrepancy, Predicted Anomaly: Yes."
2,1619000,21656,92966,-71310,Break,Significant Discrepancy,1,"Company: 2, Account: 1619000, GL Balance: 21656, IHub Balance: 92966, Balance Difference: -71310, Match Status: Break, Discrepancy Category: Significant Discrepancy, Predicted Anomaly: Yes."
3,1619000,42535,27529,15006,Break,Significant Discrepancy,1,"Company: 3, Account: 1619000, GL Balance: 42535, IHub Balance: 27529, Balance Difference: 15006, Match Status: Break, Discrepancy Category: Significant Discrepancy, Predicted Anomaly: Yes."
3,1619000,20892,95122,-74230,Break,Significant Discrepancy,1,"Company: 3, Account: 1619000, GL Balance: 20892, IHub Balance: 95122, Balance Difference: -74230, Match Status: Break, Discrepancy Category: Significant Discrepancy, Predicted Anomaly: Yes."
3,1619000,23275,44651,-21376,Break,Significant Discrepancy,1,"Company: 3, Account: 1619000, GL Balance: 23275, IHub Balance: 44651, Balance Difference: -21376, Match Status: Break, Discrepancy Category: Significant Discrepancy, Predicted Anomaly: Yes."
1,1619000,15192,70096,-54904,Break,Significant Discrepancy,1,"Company: 1, Account: 1619000, GL Balance: 15192, IHub Balance: 70096, Balance Difference: -54904, Match Status: Break, Discrepancy Category: Significant Discrepancy, Predicted Anomaly: Yes."
1,1619000,21760,66888,-45128,Break,Significant Discrepancy,1,"Company: 1, Account: 1619000, GL Balance: 21760, IHub Balance: 66888, Balance Difference: -45128, Match Status: Break, Discrepancy Category: Significant Discrepancy, Predicted Anomaly: Yes."
3,1619000,17446,67645,-50199,Break,Significant Discrepancy,1,"Company: 3, Account: 1619000, GL Balance: 17446, IHub Balance: 67645, Balance Difference: -50199, Match Status: Break, Discrepancy Category: Significant Discrepancy, Predicted Anomaly: Yes."
3,1619000,77996,66344,11652,Break,Significant Discrepancy,1,"Company: 3, Account: 1619000, GL Balance: 77996, IHub Balance: 66344, Balance Difference: 11652, Match Status: Break, Discrepancy Category: Significant Discrepancy, Predicted Anomaly: Yes."
1,1619205,45774,37843,7931,Break,Significant Discrepancy,1,"Company: 1, Account: 1619205, GL Balance: 45774, IHub Balance: 37843, Balance Difference: 7931, Match Status: Break, Discrepancy Category: Significant Discrepancy, Predicted Anomaly: Yes."
3,1619205,38343,34399,3944,Break,Significant Discrepancy,1,"Company: 3, Account: 1619205, GL Balance: 38343, IHub Balance: 34399, Balance Difference: 3944, Match Status: Break, Discrepancy Category: Significant Discrepancy, Predicted Anomaly: Yes."
3,1619205,25401,21036,4365,Break,Significant Discrepancy,1,"Company: 3, Account: 1619205, GL Balance: 25401, IHub Balance: 21036, Balance Difference: 4365, Match Status: Break, Discrepancy Category: Significant Discrepancy, Predicted Anomaly: Yes."
3,1619205,97794,35104,62690,Break,Significant Discrepancy,1,"Company: 3, Account: 1619205, GL Balance: 97794, IHub Balance: 35104, Balance Difference: 62690, Match Status: Break, Discrepancy Category: Significant Discrepancy, Predicted Anomaly: Yes."
3,1619205,55798,23795,32003,Break,Significant Discrepancy,1,"Company: 3, Account: 1619205, GL Balance: 55798, IHub Balance: 23795, Balance Difference: 32003, Match Status: Break, Discrepancy Category: Significant Discrepancy, Predicted Anomaly: Yes."
2,1619205,17612,95693,-78081,Break,Significant Discrepancy,1,"Company: 2, Account: 1619205, GL Balance: 17612, IHub Balance: 95693, Balance Difference: -78081, Match Status: Break, Discrepancy Category: Significant Discrepancy, Predicted Anomaly: Yes."
2,1619205,76961,96348,-19387,Break,Significant Discrepancy,1,"Company: 2, Account: 1619205, GL Balance: 76961, IHub Balance: 96348, Balance Difference: -19387, Match Status: Break, Discrepancy Category: Significant Discrepancy, Predicted Anomaly: Yes."
3,1619205,78775,89720,-10945,Break,Significant Discrepancy,1,"Company: 3, Account: 1619205, GL Balance: 78775, IHub Balance: 89720, Balance Difference: -10945, Match Status: Break, Discrepancy Category: Significant Discrepancy, Predicted Anomaly: Yes."
1,1619205,36986,79868,-42882,Break,Significant Discrepancy,1,"Company: 1, Account: 1619205, GL Balance: 36986, IHub Balance: 79868, Balance Difference: -42882, Match Status: Break, Discrepancy Category: Significant Discrepancy, Predicted Anomaly: Yes."
1,1619205,92861,54518,38343,Break,Significant Discrepancy,1,"Company: 1, Account: 1619205, GL Balance: 92861, IHub Balance: 54518, Balance Difference: 38343, Match Status: Break, Discrepancy Category: Significant Discrepancy, Predicted Anomaly: Yes."
2,1619205,53209,12837,40372,Break,Significant Discrepancy,1,"Company: 2, Account: 1619205, GL Balance: 53209, IHub Balance: 12837, Balance Difference: 40372, Match Status: Break, Discrepancy Category: Significant Discrepancy, Predicted Anomaly: Yes."
2,1619205,32228,39991,-7763,Break,Significant Discrepancy,1,"Company: 2, Account: 1619205, GL Balance: 32228, IHub Balance: 39991, Balance Difference: -7763, Match Status: Break, Discrepancy Category: Significant Discrepancy, Predicted Anomaly: Yes."
2,1619205,28706,63010,-34304,Break,Significant Discrepancy,1,"Company: 2, Account: 1619205, GL Balance: 28706, IHub Balance: 63010, Balance Difference: -34304, Match Status: Break, Discrepancy Category: Significant Discrepancy, Predicted Anomaly: Yes."
3,1619205,36613,71480,-34867,Break,Significant Discrepancy,1,"Company: 3, Account: 1619205, GL Balance: 36613, IHub Balance: 71480, Balance Difference: -34867, Match Status: Break, Discrepancy Category: Significant Discrepancy, Predicted Anomaly: Yes."
1,1619205,43012,20532,22480,Break,Significant Discrepancy,1,"Company: 1, Account: 1619205, GL Balance: 43012, IHub Balance: 20532, Balance Difference: 22480, Match Status: Break, Discrepancy Category: Significant Discrepancy, Predicted Anomaly: Yes."
3,1619205,60893,72901,-12008,Break,Significant Discrepancy,1,"Company: 3, Account: 1619205, GL Balance: 60893, IHub Balance: 72901, Balance Difference: -12008, Match Status: Break, Discrepancy Category: Significant Discrepancy, Predicted Anomaly: Yes."
2,1619205,13412,83309,-69897,Break,Significant Discrepancy,1,"Company: 2, Account: 1619205, GL Balance: 13412, IHub Balance: 83309, Balance Difference: -69897, Match Status: Break, Discrepancy Category: Significant Discrepancy, Predicted Anomaly: Yes."
2,1619205,97858,54358,43500,Break,Significant Discrepancy,1,"Company: 2, Account: 1619205, GL Balance: 97858, IHub Balance: 54358, Balance Difference: 43500, Match Status: Break, Discrepancy Category: Significant Discrepancy, Predicted Anomaly: Yes."
3,1619205,96310,22213,74097,Break,Significant Discrepancy,1,"Company: 3, Account: 1619205, GL Balance: 96310, IHub Balance: 22213, Balance Difference: 74097, Match Status: Break, Discrepancy Category: Significant Discrepancy, Predicted Anomaly: Yes."
1,1619205,91060,54721,36339,Break,Significant Discrepancy,1,"Company: 1, Account: 1619205, GL Balance: 91060, IHub Balance: 54721, Balance Difference: 36339, Match Status: Break, Discrepancy Category: Significant Discrepancy, Predicted Anomaly: Yes."
3,1619205,47089,65324,-18235,Break,Significant Discrepancy,1,"Company: 3, Account: 1619205, GL Balance: 47089, IHub Balance: 65324, Balance Difference: -18235, Match Status: Break, Discrepancy Category: Significant Discrepancy, Predicted Anomaly: Yes."
2,1619205,92809,49384,43425,Break,Significant Discrepancy,1,"Company: 2, Account: 1619205, GL Balance: 92809, IHub Balance: 49384, Balance Difference: 43425, Match Status: Break, Discrepancy Category: Significant Discrepancy, Predicted Anomaly: Yes."
1,1619205,64639,10209,54430,Break,Significant Discrepancy,1,"Company: 1, Account: 1619205, GL Balance: 64639, IHub Balance: 10209, Balance Difference: 54430, Match Status: Break, Discrepancy Category: Significant Discrepancy, Predicted Anomaly: Yes."
2,1619205,25082,80765,-55683,Break,Significant Discrepancy,1,"Company: 2, Account: 1619205, GL Balance: 25082, IHub Balance: 80765, Balance Difference: -55683, Match Status: Break, Discrepancy Category: Significant Discrepancy, Predicted Anomaly: Yes."
1,1619205,74947,39430,35517,Break,Significant Discrepancy,1,"Company: 1, Account: 1619205, GL Balance: 74947, IHub Balance: 39430, Balance Difference: 35517, Match Status: Break, Discrepancy Category: Significant Discrepancy, Predicted Anomaly: Yes."
1,1619205,71358,83166,-11808,Break,Significant Discrepancy,1,"Company: 1, Account: 1619205, GL Balance: 71358, IHub Balance: 83166, Balance Difference: -11808, Match Status: Break, Discrepancy Category: Significant Discrepancy, Predicted Anomaly: Yes."
2,1619205,57598,57655,-57,Match,Other,0,"Company: 2, Account: 1619205, GL Balance: 57598, IHub Balance: 57655, Balance Difference: -57, Match Status: Match, Discrepancy Category: Other, Predicted Anomaly: No."
3,1619205,91741,16780,74961,Break,Significant Discrepancy,1,"Company: 3, Account: 1619205, GL Balance: 91741, IHub Balance: 16780, Balance Difference: 74961, Match Status: Break, Discrepancy Category: Significant Discrepancy, Predicted Anomaly: Yes."
2,1619205,92896,78580,14316,Break,Significant Discrepancy,1,"Company: 2, Account: 1619205, GL Balance: 92896, IHub Balance: 78580, Balance Difference: 14316, Match Status: Break, Discrepancy Category: Significant Discrepancy, Predicted Anomaly: Yes."
1,1619205,38549,76134,-37585,Break,Significant Discrepancy,1,"Company: 1, Account: 1619205, GL Balance: 38549, IHub Balance: 76134, Balance Difference: -37585, Match Status: Break, Discrepancy Category: Significant Discrepancy, Predicted Anomaly: Yes."
3,1619205,68328,52299,16029,Break,Significant Discrepancy,1,"Company: 3, Account: 1619205, GL Balance: 68328, IHub Balance: 52299, Balance Difference: 16029, Match Status: Break, Discrepancy Category: Significant Discrepancy, Predicted Anomaly: Yes."
1,1619205,91754,24677,67077,Break,Significant Discrepancy,1,"Company: 1, Account: 1619205, GL Balance: 91754, IHub Balance: 24677, Balance Difference: 67077, Match Status: Break, Discrepancy Category: Significant Discrepancy, Predicted Anomaly: Yes."
1,1619205,47579,75532,-27953,Break,Significant Discrepancy,1,"Company: 1, Account: 1619205, GL Balance: 47579, IHub Balance: 75532, Balance Difference: -27953, Match Status: Break, Discrepancy Category: Significant Discrepancy, Predicted Anomaly: Yes."
1,1619205,33227,57482,-24255,Break,Significant Discrepancy,1,"Company: 1, Account: 1619205, GL Balance: 33227, IHub Balance: 57482, Balance Difference: -24255, Match Status: Break, Discrepancy Category: Significant Discrepancy, Predicted Anomaly: Yes."
3,1619205,11403,14833,-3430,Break,Significant Discrepancy,1,"Company: 3, Account: 1619205, GL Balance: 11403, IHub Balance: 14833, Balance Difference: -3430, Match Status: Break, Discrepancy Category: Significant Discrepancy, Predicted Anomaly: Yes."
3,1619205,67911,98606,-30695,Break,Significant Discrepancy,1,"Company: 3, Account: 1619205, GL Balance: 67911, IHub Balance: 98606, Balance Difference: -30695, Match Status: Break, Discrepancy Category: Significant Discrepancy, Predicted Anomaly: Yes."
2,1619205,82379,86860,-4481,Break,Significant Discrepancy,1,"Company: 2, Account: 1619205, GL Balance: 82379, IHub Balance: 86860, Balance Difference: -4481, Match Status: Break, Discrepancy Category: Significant Discrepancy, Predicted Anomaly: Yes."
1,1619205,49770,86820,-37050,Break,Significant Discrepancy,1,"Company: 1, Account: 1619205, GL Balance: 49770, IHub Balance: 86820, Balance Difference: -37050, Match Status: Break, Discrepancy Category: Significant Discrepancy, Predicted Anomaly: Yes."
1,1619205,39377,84723,-45346,Break,Significant Discrepancy,1,"Company: 1, Account: 1619205, GL Balance: 39377, IHub Balance: 84723, Balance Difference: -45346, Match Status: Break, Discrepancy Category: Significant Discrepancy, Predicted Anomaly: Yes."
2,1619205,43257,89303,-46046,Break,Significant Discrepancy,1,"Company: 2, Account: 1619205, GL Balance: 43257, IHub Balance: 89303, Balance Difference: -46046, Match Status: Break, Discrepancy Category: Significant Discrepancy, Predicted Anomaly: Yes."
2,1619205,70561,59819,10742,Break,Significant Discrepancy,1,"Company: 2, Account: 1619205, GL Balance: 70561, IHub Balance: 59819, Balance Difference: 10742, Match Status: Break, Discrepancy Category: Significant Discrepancy, Predicted Anomaly: Yes."
2,1619205,17523,17637,-114,Match,Other,0,"Company: 2, Account: 1619205, GL Balance: 17523, IHub Balance: 17637, Balance Difference: -114, Match Status: Match, Discrepancy Category: Other, Predicted Anomaly: No."
2,1619205,10364,28799,-18435,Break,Significant Discrepancy,1,"Company: 2, Account: 1619205, GL Balance: 10364, IHub Balance: 28799, Balance Difference: -18435, Match Status: Break, Discrepancy Category: Significant Discrepancy, Predicted Anomaly: Yes."
1,1619205,64412,40782,23630,Break,Significant Discrepancy,1,"Company: 1, Account: 1619205, GL Balance: 64412, IHub Balance: 40782, Balance Difference: 23630, Match Status: Break, Discrepancy Category: Significant Discrepancy, Predicted Anomaly: Yes."
1,1619205,19972,76168,-56196,Break,Significant Discrepancy,1,"Company: 1, Account: 1619205, GL Balance: 19972, IHub Balance: 76168, Balance Difference: -56196, Match Status: Break, Discrepancy Category: Significant Discrepancy, Predicted Anomaly: Yes."
3,1619205,57096,35595,21501,Break,Significant Discrepancy,1,"Company: 3, Account: 1619205, GL Balance: 57096, IHub Balance: 35595, Balance Difference: 21501, Match Status: Break, Discrepancy Category: Significant Discrepancy, Predicted Anomaly: Yes."
3,1619205,99922,14512,85410,Break,Significant Discrepancy,1,"Company: 3, Account: 1619205, GL Balance: 99922, IHub Balance: 14512, Balance Difference: 85410, Match Status: Break, Discrepancy Category: Significant Discrepancy, Predicted Anomaly: Yes."
3,1619205,27323,47763,-20440,Break,Significant Discrepancy,1,"Company: 3, Account: 1619205, GL Balance: 27323, IHub Balance: 47763, Balance Difference: -20440, Match Status: Break, Discrepancy Category: Significant Discrepancy, Predicted Anomaly: Yes."
2,1619205,52249,59950,-7701,Break,Significant Discrepancy,1,"Company: 2, Account: 1619205, GL Balance: 52249, IHub Balance: 59950, Balance Difference: -7701, Match Status: Break, Discrepancy Category: Significant Discrepancy, Predicted Anomaly: Yes."
3,1619205,27157,99233,-72076,Break,Significant Discrepancy,1,"Company: 3, Account: 1619205, GL Balance: 27157, IHub Balance: 99233, Balance Difference: -72076, Match Status: Break, Discrepancy Category: Significant Discrepancy, Predicted Anomaly: Yes."
1,1619205,66176,87061,-20885,Break,Significant Discrepancy,1,"Company: 1, Account: 1619205, GL Balance: 66176, IHub Balance: 87061, Balance Difference: -20885, Match Status: Break, Discrepancy Category: Significant Discrepancy, Predicted Anomaly: Yes."
3,1619205,23266,50002,-26736,Break,Significant Discrepancy,1,"Company: 3, Account: 1619205, GL Balance: 23266, IHub Balance: 50002, Balance Difference: -26736, Match Status: Break, Discrepancy Category: Significant Discrepancy, Predicted Anomaly: Yes."
1,1619205,37713,83545,-45832,Break,Significant Discrepancy,1,"Company: 1, Account: 1619205, GL Balance: 37713, IHub Balance: 83545, Balance Difference: -45832, Match Status: Break, Discrepancy Category: Significant Discrepancy, Predicted Anomaly: Yes."
1,1619205,34714,86515,-51801,Break,Significant Discrepancy,1,"Company: 1, Account: 1619205, GL Balance: 34714, IHub Balance: 86515, Balance Difference: -51801, Match Status: Break, Discrepancy Category: Significant Discrepancy, Predicted Anomaly: Yes."
2,1619205,99792,36797,62995,Break,Significant Discrepancy,1,"Company: 2, Account: 1619205, GL Balance: 99792, IHub Balance: 36797, Balance Difference: 62995, Match Status: Break, Discrepancy Category: Significant Discrepancy, Predicted Anomaly: Yes."
3,1619205,22516,43205,-20689,Break,Significant Discrepancy,1,"Company: 3, Account: 1619205, GL Balance: 22516, IHub Balance: 43205, Balance Difference: -20689, Match Status: Break, Discrepancy Category: Significant Discrepancy, Predicted Anomaly: Yes."
1,1619205,92190,93768,-1578,Break,Significant Discrepancy,1,"Company: 1, Account: 1619205, GL Balance: 92190, IHub Balance: 93768, Balance Difference: -1578, Match Status: Break, Discrepancy Category: Significant Discrepancy, Predicted Anomaly: Yes."
3,1619205,23026,66221,-43195,Break,Significant Discrepancy,1,"Company: 3, Account: 1619205, GL Balance: 23026, IHub Balance: 66221, Balance Difference: -43195, Match Status: Break, Discrepancy Category: Significant Discrepancy, Predicted Anomaly: Yes."
2,1619205,35762,51616,-15854,Break,Significant Discrepancy,1,"Company: 2, Account: 1619205, GL Balance: 35762, IHub Balance: 51616, Balance Difference: -15854, Match Status: Break, Discrepancy Category: Significant Discrepancy, Predicted Anomaly: Yes."
2,1619205,88199,25120,63079,Break,Significant Discrepancy,1,"Company: 2, Account: 1619205, GL Balance: 88199, IHub Balance: 25120, Balance Difference: 63079, Match Status: Break, Discrepancy Category: Significant Discrepancy, Predicted Anomaly: Yes."
2,1619205,56501,49477,7024,Break,Significant Discrepancy,1,"Company: 2, Account: 1619205, GL Balance: 56501, IHub Balance: 49477, Balance Difference: 7024, Match Status: Break, Discrepancy Category: Significant Discrepancy, Predicted Anomaly: Yes."
2,1619205,44568,33555,11013,Break,Significant Discrepancy,1,"Company: 2, Account: 1619205, GL Balance: 44568, IHub Balance: 33555, Balance Difference: 11013, Match Status: Break, Discrepancy Category: Significant Discrepancy, Predicted Anomaly: Yes."
2,1619205,50088,96008,-45920,Break,Significant Discrepancy,1,"Company: 2, Account: 1619205, GL Balance: 50088, IHub Balance: 96008, Balance Difference: -45920, Match Status: Break, Discrepancy Category: Significant Discrepancy, Predicted Anomaly: Yes."
3,1619205,24080,98284,-74204,Break,Significant Discrepancy,1,"Company: 3, Account: 1619205, GL Balance: 24080, IHub Balance: 98284, Balance Difference: -74204, Match Status: Break, Discrepancy Category: Significant Discrepancy, Predicted Anomaly: Yes."
3,1619205,34003,59752,-25749,Break,Significant Discrepancy,1,"Company: 3, Account: 1619205, GL Balance: 34003, IHub Balance: 59752, Balance Difference: -25749, Match Status: Break, Discrepancy Category: Significant Discrepancy, Predicted Anomaly: Yes."
3,1619205,25438,37939,-12501,Break,Significant Discrepancy,1,"Company: 3, Account: 1619205, GL Balance: 25438, IHub Balance: 37939, Balance Difference: -12501, Match Status: Break, Discrepancy Category: Significant Discrepancy, Predicted Anomaly: Yes."
1,1619205,47412,74680,-27268,Break,Significant Discrepancy,1,"Company: 1, Account: 1619205, GL Balance: 47412, IHub Balance: 74680, Balance Difference: -27268, Match Status: Break, Discrepancy Category: Significant Discrepancy, Predicted Anomaly: Yes."
2,1619205,23739,33123,-9384,Break,Significant Discrepancy,1,"Company: 2, Account: 1619205, GL Balance: 23739, IHub Balance: 33123, Balance Difference: -9384, Match Status: Break, Discrepancy Category: Significant Discrepancy, Predicted Anomaly: Yes."
3,1619205,28895,82932,-54037,Break,Significant Discrepancy,1,"Company: 3, Account: 1619205, GL Balance: 28895, IHub Balance: 82932, Balance Difference: -54037, Match Status: Break, Discrepancy Category: Significant Discrepancy, Predicted Anomaly: Yes."
1,1619205,97566,96105,1461,Break,Significant Discrepancy,1,"Company: 1, Account: 1619205, GL Balance: 97566, IHub Balance: 96105, Balance Difference: 1461, Match Status: Break, Discrepancy Category: Significant Discrepancy, Predicted Anomaly: Yes."
3,1619205,89464,73027,16437,Break,Significant Discrepancy,1,"Company: 3, Account: 1619205, GL Balance: 89464, IHub Balance: 73027, Balance Difference: 16437, Match Status: Break, Discrepancy Category: Significant Discrepancy, Predicted Anomaly: Yes."
1,1619205,20435,53463,-33028,Break,Significant Discrepancy,1,"Company: 1, Account: 1619205, GL Balance: 20435, IHub Balance: 53463, Balance Difference: -33028, Match Status: Break, Discrepancy Category: Significant Discrepancy, Predicted Anomaly: Yes."
1,1619205,74555,70032,4523,Break,Significant Discrepancy,1,"Company: 1, Account: 1619205, GL Balance: 74555, IHub Balance: 70032, Balance Difference: 4523, Match Status: Break, Discrepancy Category: Significant Discrepancy, Predicted Anomaly: Yes."
2,1619205,68420,71821,-3401,Break,Significant Discrepancy,1,"Company: 2, Account: 1619205, GL Balance: 68420, IHub Balance: 71821, Balance Difference: -3401, Match Status: Break, Discrepancy Category: Significant Discrepancy, Predicted Anomaly: Yes."
2,1619205,97502,51632,45870,Break,Significant Discrepancy,1,"Company: 2, Account: 1619205, GL Balance: 97502, IHub Balance: 51632, Balance Difference: 45870, Match Status: Break, Discrepancy Category: Significant Discrepancy, Predicted Anomaly: Yes."
1,1619205,76729,79050,-2321,Break,Significant Discrepancy,1,"Company: 1, Account: 1619205, GL Balance: 76729, IHub Balance: 79050, Balance Difference: -2321, Match Status: Break, Discrepancy Category: Significant Discrepancy, Predicted Anomaly: Yes."
1,1619205,19476,11883,7593,Break,Significant Discrepancy,1,"Company: 1, Account: 1619205, GL Balance: 19476, IHub Balance: 11883, Balance Difference: 7593, Match Status: Break, Discrepancy Category: Significant Discrepancy, Predicted Anomaly: Yes."
3,1619205,17310,15539,1771,Break,Significant Discrepancy,1,"Company: 3, Account: 1619205, GL Balance: 17310, IHub Balance: 15539, Balance Difference: 1771, Match Status: Break, Discrepancy Category: Significant Discrepancy, Predicted Anomaly: Yes."
2,1619205,18859,86281,-67422,Break,Significant Discrepancy,1,"Company: 2, Account: 1619205, GL Balance: 18859, IHub Balance: 86281, Balance Difference: -67422, Match Status: Break, Discrepancy Category: Significant Discrepancy, Predicted Anomaly: Yes."
2,1619205,96457,92665,3792,Break,Significant Discrepancy,1,"Company: 2, Account: 1619205, GL Balance: 96457, IHub Balance: 92665, Balance Difference: 3792, Match Status: Break, Discrepancy Category: Significant Discrepancy, Predicted Anomaly: Yes."
1,1619205,80382,32666,47716,Break,Significant Discrepancy,1,"Company: 1, Account: 1619205, GL Balance: 80382, IHub Balance: 32666, Balance Difference: 47716, Match Status: Break, Discrepancy Category: Significant Discrepancy, Predicted Anomaly: Yes."
2,1619205,14302,19046,-4744,Break,Significant Discrepancy,1,"Company: 2, Account: 1619205, GL Balance: 14302, IHub Balance: 19046, Balance Difference: -4744, Match Status: Break, Discrepancy Category: Significant Discrepancy, Predicted Anomaly: Yes."
1,1619205,52487,50077,2410,Break,Significant Discrepancy,1,"Company: 1, Account: 1619205, GL Balance: 52487, IHub Balance: 50077, Balance Difference: 2410, Match Status: Break, Discrepancy Category: Significant Discrepancy, Predicted Anomaly: Yes."
1,1619205,22055,10840,11215,Break,Significant Discrepancy,1,"Company: 1, Account: 1619205, GL Balance: 22055, IHub Balance: 10840, Balance Difference: 11215, Match Status: Break, Discrepancy Category: Significant Discrepancy, Predicted Anomaly: Yes."
3,1619205,97822,56336,41486,Break,Significant Discrepancy,1,"Company: 3, Account: 1619205, GL Balance: 97822, IHub Balance: 56336, Balance Difference: 41486, Match Status: Break, Discrepancy Category: Significant Discrepancy, Predicted Anomaly: Yes."
2,1619205,23285,67256,-43971,Break,Significant Discrepancy,1,"Company: 2, Account: 1619205, GL Balance: 23285, IHub Balance: 67256, Balance Difference: -43971, Match Status: Break, Discrepancy Category: Significant Discrepancy, Predicted Anomaly: Yes."
2,1619205,95149,76615,18534,Break,Significant Discrepancy,1,"Company: 2, Account: 1619205, GL Balance: 95149, IHub Balance: 76615, Balance Difference: 18534, Match Status: Break, Discrepancy Category: Significant Discrepancy, Predicted Anomaly: Yes."
1,1619205,16458,33572,-17114,Break,Significant Discrepancy,1,"Company: 1, Account: 1619205, GL Balance: 16458, IHub Balance: 33572, Balance Difference: -17114, Match Status: Break, Discrepancy Category: Significant Discrepancy, Predicted Anomaly: Yes."
2,1619205,38363,69812,-31449,Break,Significant Discrepancy,1,"Company: 2, Account: 1619205, GL Balance: 38363, IHub Balance: 69812, Balance Difference: -31449, Match Status: Break, Discrepancy Category: Significant Discrepancy, Predicted Anomaly: Yes."
2,1619205,22120,30156,-8036,Break,Significant Discrepancy,1,"Company: 2, Account: 1619205, GL Balance: 22120, IHub Balance: 30156, Balance Difference: -8036, Match Status: Break, Discrepancy Category: Significant Discrepancy, Predicted Anomaly: Yes."
3,1619205,26043,84816,-58773,Break,Significant Discrepancy,1,"Company: 3, Account: 1619205, GL Balance: 26043, IHub Balance: 84816, Balance Difference: -58773, Match Status: Break, Discrepancy Category: Significant Discrepancy, Predicted Anomaly: Yes."
3,1619205,35192,15782,19410,Break,Significant Discrepancy,1,"Company: 3, Account: 1619205, GL Balance: 35192, IHub Balance: 15782, Balance Difference: 19410, Match Status: Break, Discrepancy Category: Significant Discrepancy, Predicted Anomaly: Yes."
1,1619205,86349,99314,-12965,Break,Significant Discrepancy,1,"Company: 1, Account: 1619205, GL Balance: 86349, IHub Balance: 99314, Balance Difference: -12965, Match Status: Break, Discrepancy Category: Significant Discrepancy, Predicted Anomaly: Yes."
1,1619205,10037,20482,-10445,Break,Significant Discrepancy,1,"Company: 1, Account: 1619205, GL Balance: 10037, IHub Balance: 20482, Balance Difference: -10445, Match Status: Break, Discrepancy Category: Significant Discrepancy, Predicted Anomaly: Yes."
1,1619205,25167,27671,-2504,Break,Significant Discrepancy,1,"Company: 1, Account: 1619205, GL Balance: 25167, IHub Balance: 27671, Balance Difference: -2504, Match Status: Break, Discrepancy Category: Significant Discrepancy, Predicted Anomaly: Yes."
1,1619205,40783,27165,13618,Break,Significant Discrepancy,1,"Company: 1, Account: 1619205, GL Balance: 40783, IHub Balance: 27165, Balance Difference: 13618, Match Status: Break, Discrepancy Category: Significant Discrepancy, Predicted Anomaly: Yes."
3,1619205,14725,41996,-27271,Break,Significant Discrepancy,1,"Company: 3, Account: 1619205, GL Balance: 14725, IHub Balance: 41996, Balance Difference: -27271, Match Status: Break, Discrepancy Category: Significant Discrepancy, Predicted Anomaly: Yes."
2,1619205,80429,79726,703,Match,Other,0,"Company: 2, Account: 1619205, GL Balance: 80429, IHub Balance: 79726, Balance Difference: 703, Match Status: Match, Discrepancy Category: Other, Predicted Anomaly: No."
3,1619205,60411,77650,-17239,Break,Significant Discrepancy,1,"Company: 3, Account: 1619205, GL Balance: 60411, IHub Balance: 77650, Balance Difference: -17239, Match Status: Break, Discrepancy Category: Significant Discrepancy, Predicted Anomaly: Yes."
2,1619205,98714,22043,76671,Break,Significant Discrepancy,1,"Company: 2, Account: 1619205, GL Balance: 98714, IHub Balance: 22043, Balance Difference: 76671, Match Status: Break, Discrepancy Category: Significant Discrepancy, Predicted Anomaly: Yes."
2,1619205,77321,33238,44083,Break,Significant Discrepancy,1,"Company: 2, Account: 1619205, GL Balance: 77321, IHub Balance: 33238, Balance Difference: 44083, Match Status: Break, Discrepancy Category: Significant Discrepancy, Predicted Anomaly: Yes."
3,1619205,28205,14722,13483,Break,Significant Discrepancy,1,"Company: 3, Account: 1619205, GL Balance: 28205, IHub Balance: 14722, Balance Difference: 13483, Match Status: Break, Discrepancy Category: Significant Discrepancy, Predicted Anomaly: Yes."
1,1619205,19372,90083,-70711,Break,Significant Discrepancy,1,"Company: 1, Account: 1619205, GL Balance: 19372, IHub Balance: 90083, Balance Difference: -70711, Match Status: Break, Discrepancy Category: Significant Discrepancy, Predicted Anomaly: Yes."
2,1619205,96907,22002,74905,Break,Significant Discrepancy,1,"Company: 2, Account: 1619205, GL Balance: 96907, IHub Balance: 22002, Balance Difference: 74905, Match Status: Break, Discrepancy Category: Significant Discrepancy, Predicted Anomaly: Yes."
3,1619205,42813,96593,-53780,Break,Significant Discrepancy,1,"Company: 3, Account: 1619205, GL Balance: 42813, IHub Balance: 96593, Balance Difference: -53780, Match Status: Break, Discrepancy Category: Significant Discrepancy, Predicted Anomaly: Yes."
3,1619205,22363,24123,-1760,Break,Significant Discrepancy,1,"Company: 3, Account: 1619205, GL Balance: 22363, IHub Balance: 24123, Balance Difference: -1760, Match Status: Break, Discrepancy Category: Significant Discrepancy, Predicted Anomaly: Yes."
1,1619205,47297,56648,-9351,Break,Significant Discrepancy,1,"Company: 1, Account: 1619205, GL Balance: 47297, IHub Balance: 56648, Balance Difference: -9351, Match Status: Break, Discrepancy Category: Significant Discrepancy, Predicted Anomaly: Yes."
1,1619205,23877,67395,-43518,Break,Significant Discrepancy,1,"Company: 1, Account: 1619205, GL Balance: 23877, IHub Balance: 67395, Balance Difference: -43518, Match Status: Break, Discrepancy Category: Significant Discrepancy, Predicted Anomaly: Yes."
3,1619205,12015,93804,-81789,Break,Significant Discrepancy,1,"Company: 3, Account: 1619205, GL Balance: 12015, IHub Balance: 93804, Balance Difference: -81789, Match Status: Break, Discrepancy Category: Significant Discrepancy, Predicted Anomaly: Yes."
1,1619205,51941,98553,-46612,Break,Significant Discrepancy,1,"Company: 1, Account: 1619205, GL Balance: 51941, IHub Balance: 98553, Balance Difference: -46612, Match Status: Break, Discrepancy Category: Significant Discrepancy, Predicted Anomaly: Yes."
3,1619205,30369,45057,-14688,Break,Significant Discrepancy,1,"Company: 3, Account: 1619205, GL Balance: 30369, IHub Balance: 45057, Balance Difference: -14688, Match Status: Break, Discrepancy Category: Significant Discrepancy, Predicted Anomaly: Yes."
2,1619205,84632,79002,5630,Break,Significant Discrepancy,1,"Company: 2, Account: 1619205, GL Balance: 84632, IHub Balance: 79002, Balance Difference: 5630, Match Status: Break, Discrepancy Category: Significant Discrepancy, Predicted Anomaly: Yes."
3,1619205,80880,34435,46445,Break,Significant Discrepancy,1,"Company: 3, Account: 1619205, GL Balance: 80880, IHub Balance: 34435, Balance Difference: 46445, Match Status: Break, Discrepancy Category: Significant Discrepancy, Predicted Anomaly: Yes."
1,1619205,14725,64471,-49746,Break,Significant Discrepancy,1,"Company: 1, Account: 1619205, GL Balance: 14725, IHub Balance: 64471, Balance Difference: -49746, Match Status: Break, Discrepancy Category: Significant Discrepancy, Predicted Anomaly: Yes."
3,1619205,23313,73138,-49825,Break,Significant Discrepancy,1,"Company: 3, Account: 1619205, GL Balance: 23313, IHub Balance: 73138, Balance Difference: -49825, Match Status: Break, Discrepancy Category: Significant Discrepancy, Predicted Anomaly: Yes."
1,1619205,18572,87066,-68494,Break,Significant Discrepancy,1,"Company: 1, Account: 1619205, GL Balance: 18572, IHub Balance: 87066, Balance Difference: -68494, Match Status: Break, Discrepancy Category: Significant Discrepancy, Predicted Anomaly: Yes."
2,1619205,73755,11359,62396,Break,Significant Discrepancy,1,"Company: 2, Account: 1619205, GL Balance: 73755, IHub Balance: 11359, Balance Difference: 62396, Match Status: Break, Discrepancy Category: Significant Discrepancy, Predicted Anomaly: Yes."
2,1619205,51916,14695,37221,Break,Significant Discrepancy,1,"Company: 2, Account: 1619205, GL Balance: 51916, IHub Balance: 14695, Balance Difference: 37221, Match Status: Break, Discrepancy Category: Significant Discrepancy, Predicted Anomaly: Yes."
2,1619205,64544,77619,-13075,Break,Significant Discrepancy,1,"Company: 2, Account: 1619205, GL Balance: 64544, IHub Balance: 77619, Balance Difference: -13075, Match Status: Break, Discrepancy Category: Significant Discrepancy, Predicted Anomaly: Yes."
3,1619205,32419,10916,21503,Break,Significant Discrepancy,1,"Company: 3, Account: 1619205, GL Balance: 32419, IHub Balance: 10916, Balance Difference: 21503, Match Status: Break, Discrepancy Category: Significant Discrepancy, Predicted Anomaly: Yes."
3,1619205,52531,34188,18343,Break,Significant Discrepancy,1,"Company: 3, Account: 1619205, GL Balance: 52531, IHub Balance: 34188, Balance Difference: 18343, Match Status: Break, Discrepancy Category: Significant Discrepancy, Predicted Anomaly: Yes."
1,1619205,36745,88943,-52198,Break,Significant Discrepancy,1,"Company: 1, Account: 1619205, GL Balance: 36745, IHub Balance: 88943, Balance Difference: -52198, Match Status: Break, Discrepancy Category: Significant Discrepancy, Predicted Anomaly: Yes."
1,1619205,97858,71160,26698,Break,Significant Discrepancy,1,"Company: 1, Account: 1619205, GL Balance: 97858, IHub Balance: 71160, Balance Difference: 26698, Match Status: Break, Discrepancy Category: Significant Discrepancy, Predicted Anomaly: Yes."
3,1619205,75792,93251,-17459,Break,Significant Discrepancy,1,"Company: 3, Account: 1619205, GL Balance: 75792, IHub Balance: 93251, Balance Difference: -17459, Match Status: Break, Discrepancy Category: Significant Discrepancy, Predicted Anomaly: Yes."
3,1619205,95597,39204,56393,Break,Significant Discrepancy,1,"Company: 3, Account: 1619205, GL Balance: 95597, IHub Balance: 39204, Balance Difference: 56393, Match Status: Break, Discrepancy Category: Significant Discrepancy, Predicted Anomaly: Yes."
2,1619205,87198,32551,54647,Break,Significant Discrepancy,1,"Company: 2, Account: 1619205, GL Balance: 87198, IHub Balance: 32551, Balance Difference: 54647, Match Status: Break, Discrepancy Category: Significant Discrepancy, Predicted Anomaly: Yes."
2,1619205,21672,67811,-46139,Break,Significant Discrepancy,1,"Company: 2, Account: 1619205, GL Balance: 21672, IHub Balance: 67811, Balance Difference: -46139, Match Status: Break, Discrepancy Category: Significant Discrepancy, Predicted Anomaly: Yes."
1,1619205,38797,30169,8628,Break,Significant Discrepancy,1,"Company: 1, Account: 1619205, GL Balance: 38797, IHub Balance: 30169, Balance Difference: 8628, Match Status: Break, Discrepancy Category: Significant Discrepancy, Predicted Anomaly: Yes."
1,1619205,20131,53351,-33220,Break,Significant Discrepancy,1,"Company: 1, Account: 1619205, GL Balance: 20131, IHub Balance: 53351, Balance Difference: -33220, Match Status: Break, Discrepancy Category: Significant Discrepancy, Predicted Anomaly: Yes."
1,1619205,93694,39377,54317,Break,Significant Discrepancy,1,"Company: 1, Account: 1619205, GL Balance: 93694, IHub Balance: 39377, Balance Difference: 54317, Match Status: Break, Discrepancy Category: Significant Discrepancy, Predicted Anomaly: Yes."
1,1619205,89468,92824,-3356,Break,Significant Discrepancy,1,"Company: 1, Account: 1619205, GL Balance: 89468, IHub Balance: 92824, Balance Difference: -3356, Match Status: Break, Discrepancy Category: Significant Discrepancy, Predicted Anomaly: Yes."
1,1619205,24855,81127,-56272,Break,Significant Discrepancy,1,"Company: 1, Account: 1619205, GL Balance: 24855, IHub Balance: 81127, Balance Difference: -56272, Match Status: Break, Discrepancy Category: Significant Discrepancy, Predicted Anomaly: Yes."
2,1619205,68182,35411,32771,Break,Significant Discrepancy,1,"Company: 2, Account: 1619205, GL Balance: 68182, IHub Balance: 35411, Balance Difference: 32771, Match Status: Break, Discrepancy Category: Significant Discrepancy, Predicted Anomaly: Yes."
2,1619205,82833,47030,35803,Break,Significant Discrepancy,1,"Company: 2, Account: 1619205, GL Balance: 82833, IHub Balance: 47030, Balance Difference: 35803, Match Status: Break, Discrepancy Category: Significant Discrepancy, Predicted Anomaly: Yes."
3,1619205,38225,24318,13907,Break,Significant Discrepancy,1,"Company: 3, Account: 1619205, GL Balance: 38225, IHub Balance: 24318, Balance Difference: 13907, Match Status: Break, Discrepancy Category: Significant Discrepancy, Predicted Anomaly: Yes."
2,1619205,56926,37588,19338,Break,Significant Discrepancy,1,"Company: 2, Account: 1619205, GL Balance: 56926, IHub Balance: 37588, Balance Difference: 19338, Match Status: Break, Discrepancy Category: Significant Discrepancy, Predicted Anomaly: Yes."
3,1619205,88113,58926,29187,Break,Significant Discrepancy,1,"Company: 3, Account: 1619205, GL Balance: 88113, IHub Balance: 58926, Balance Difference: 29187, Match Status: Break, Discrepancy Category: Significant Discrepancy, Predicted Anomaly: Yes."
2,1619205,83914,43583,40331,Break,Significant Discrepancy,1,"Company: 2, Account: 1619205, GL Balance: 83914, IHub Balance: 43583, Balance Difference: 40331, Match Status: Break, Discrepancy Category: Significant Discrepancy, Predicted Anomaly: Yes."
1,1619205,11875,12108,-233,Match,Other,0,"Company: 1, Account: 1619205, GL Balance: 11875, IHub Balance: 12108, Balance Difference: -233, Match Status: Match, Discrepancy Category: Other, Predicted Anomaly: No."
2,1619205,35025,49080,-14055,Break,Significant Discrepancy,1,"Company: 2, Account: 1619205, GL Balance: 35025, IHub Balance: 49080, Balance Difference: -14055, Match Status: Break, Discrepancy Category: Significant Discrepancy, Predicted Anomaly: Yes."
2,1619205,46737,84877,-38140,Break,Significant Discrepancy,1,"Company: 2, Account: 1619205, GL Balance: 46737, IHub Balance: 84877, Balance Difference: -38140, Match Status: Break, Discrepancy Category: Significant Discrepancy, Predicted Anomaly: Yes."
3,1619205,70156,39669,30487,Break,Significant Discrepancy,1,"Company: 3, Account: 1619205, GL Balance: 70156, IHub Balance: 39669, Balance Difference: 30487, Match Status: Break, Discrepancy Category: Significant Discrepancy, Predicted Anomaly: Yes."
2,1619205,33396,23844,9552,Break,Significant Discrepancy,1,"Company: 2, Account: 1619205, GL Balance: 33396, IHub Balance: 23844, Balance Difference: 9552, Match Status: Break, Discrepancy Category: Significant Discrepancy, Predicted Anomaly: Yes."
2,1619205,40255,10636,29619,Break,Significant Discrepancy,1,"Company: 2, Account: 1619205, GL Balance: 40255, IHub Balance: 10636, Balance Difference: 29619, Match Status: Break, Discrepancy Category: Significant Discrepancy, Predicted Anomaly: Yes."
3,1619205,10432,12970,-2538,Break,Significant Discrepancy,1,"Company: 3, Account: 1619205, GL Balance: 10432, IHub Balance: 12970, Balance Difference: -2538, Match Status: Break, Discrepancy Category: Significant Discrepancy, Predicted Anomaly: Yes."
1,1619205,20416,91678,-71262,Break,Significant Discrepancy,1,"Company: 1, Account: 1619205, GL Balance: 20416, IHub Balance: 91678, Balance Difference: -71262, Match Status: Break, Discrepancy Category: Significant Discrepancy, Predicted Anomaly: Yes."
3,1619205,43351,23280,20071,Break,Significant Discrepancy,1,"Company: 3, Account: 1619205, GL Balance: 43351, IHub Balance: 23280, Balance Difference: 20071, Match Status: Break, Discrepancy Category: Significant Discrepancy, Predicted Anomaly: Yes."
1,1619205,58002,93337,-35335,Break,Significant Discrepancy,1,"Company: 1, Account: 1619205, GL Balance: 58002, IHub Balance: 93337, Balance Difference: -35335, Match Status: Break, Discrepancy Category: Significant Discrepancy, Predicted Anomaly: Yes."
1,1619205,61720,87583,-25863,Break,Significant Discrepancy,1,"Company: 1, Account: 1619205, GL Balance: 61720, IHub Balance: 87583, Balance Difference: -25863, Match Status: Break, Discrepancy Category: Significant Discrepancy, Predicted Anomaly: Yes."
1,1619205,81492,33244,48248,Break,Significant Discrepancy,1,"Company: 1, Account: 1619205, GL Balance: 81492, IHub Balance: 33244, Balance Difference: 48248, Match Status: Break, Discrepancy Category: Significant Discrepancy, Predicted Anomaly: Yes."
3,1619205,10909,59306,-48397,Break,Significant Discrepancy,1,"Company: 3, Account: 1619205, GL Balance: 10909, IHub Balance: 59306, Balance Difference: -48397, Match Status: Break, Discrepancy Category: Significant Discrepancy, Predicted Anomaly: Yes."
2,1619205,56540,76101,-19561,Break,Significant Discrepancy,1,"Company: 2, Account: 1619205, GL Balance: 56540, IHub Balance: 76101, Balance Difference: -19561, Match Status: Break, Discrepancy Category: Significant Discrepancy, Predicted Anomaly: Yes."
3,1619205,34544,80114,-45570,Break,Significant Discrepancy,1,"Company: 3, Account: 1619205, GL Balance: 34544, IHub Balance: 80114, Balance Difference: -45570, Match Status: Break, Discrepancy Category: Significant Discrepancy, Predicted Anomaly: Yes."
2,1619205,16449,69858,-53409,Break,Significant Discrepancy,1,"Company: 2, Account: 1619205, GL Balance: 16449, IHub Balance: 69858, Balance Difference: -53409, Match Status: Break, Discrepancy Category: Significant Discrepancy, Predicted Anomaly: Yes."
2,1619205,78950,98001,-19051,Break,Significant Discrepancy,1,"Company: 2, Account: 1619205, GL Balance: 78950, IHub Balance: 98001, Balance Difference: -19051, Match Status: Break, Discrepancy Category: Significant Discrepancy, Predicted Anomaly: Yes."
3,1619205,64437,37206,27231,Break,Significant Discrepancy,1,"Company: 3, Account: 1619205, GL Balance: 64437, IHub Balance: 37206, Balance Difference: 27231, Match Status: Break, Discrepancy Category: Significant Discrepancy, Predicted Anomaly: Yes."
2,1619205,20391,78684,-58293,Break,Significant Discrepancy,1,"Company: 2, Account: 1619205, GL Balance: 20391, IHub Balance: 78684, Balance Difference: -58293, Match Status: Break, Discrepancy Category: Significant Discrepancy, Predicted Anomaly: Yes."
1,1619205,30800,83374,-52574,Break,Significant Discrepancy,1,"Company: 1, Account: 1619205, GL Balance: 30800, IHub Balance: 83374, Balance Difference: -52574, Match Status: Break, Discrepancy Category: Significant Discrepancy, Predicted Anomaly: Yes."
3,1619205,44959,10386,34573,Break,Significant Discrepancy,1,"Company: 3, Account: 1619205, GL Balance: 44959, IHub Balance: 10386, Balance Difference: 34573, Match Status: Break, Discrepancy Category: Significant Discrepancy, Predicted Anomaly: Yes."
1,1619205,76324,58671,17653,Break,Significant Discrepancy,1,"Company: 1, Account: 1619205, GL Balance: 76324, IHub Balance: 58671, Balance Difference: 17653, Match Status: Break, Discrepancy Category: Significant Discrepancy, Predicted Anomaly: Yes."
3,1619205,54648,30946,23702,Break,Significant Discrepancy,1,"Company: 3, Account: 1619205, GL Balance: 54648, IHub Balance: 30946, Balance Difference: 23702, Match Status: Break, Discrepancy Category: Significant Discrepancy, Predicted Anomaly: Yes."
2,1619205,51708,82499,-30791,Break,Significant Discrepancy,1,"Company: 2, Account: 1619205, GL Balance: 51708, IHub Balance: 82499, Balance Difference: -30791, Match Status: Break, Discrepancy Category: Significant Discrepancy, Predicted Anomaly: Yes."
3,1619205,13621,68784,-55163,Break,Significant Discrepancy,1,"Company: 3, Account: 1619205, GL Balance: 13621, IHub Balance: 68784, Balance Difference: -55163, Match Status: Break, Discrepancy Category: Significant Discrepancy, Predicted Anomaly: Yes."
2,1619205,35705,57367,-21662,Break,Significant Discrepancy,1,"Company: 2, Account: 1619205, GL Balance: 35705, IHub Balance: 57367, Balance Difference: -21662, Match Status: Break, Discrepancy Category: Significant Discrepancy, Predicted Anomaly: Yes."
2,1619205,70180,78126,-7946,Break,Significant Discrepancy,1,"Company: 2, Account: 1619205, GL Balance: 70180, IHub Balance: 78126, Balance Difference: -7946, Match Status: Break, Discrepancy Category: Significant Discrepancy, Predicted Anomaly: Yes."
1,1619205,89944,92970,-3026,Break,Significant Discrepancy,1,"Company: 1, Account: 1619205, GL Balance: 89944, IHub Balance: 92970, Balance Difference: -3026, Match Status: Break, Discrepancy Category: Significant Discrepancy, Predicted Anomaly: Yes."
3,1619205,95843,59984,35859,Break,Significant Discrepancy,1,"Company: 3, Account: 1619205, GL Balance: 95843, IHub Balance: 59984, Balance Difference: 35859, Match Status: Break, Discrepancy Category: Significant Discrepancy, Predicted Anomaly: Yes."
1,1619205,65381,96928,-31547,Break,Significant Discrepancy,1,"Company: 1, Account: 1619205, GL Balance: 65381, IHub Balance: 96928, Balance Difference: -31547, Match Status: Break, Discrepancy Category: Significant Discrepancy, Predicted Anomaly: Yes."
2,1619205,15167,23833,-8666,Break,Significant Discrepancy,1,"Company: 2, Account: 1619205, GL Balance: 15167, IHub Balance: 23833, Balance Difference: -8666, Match Status: Break, Discrepancy Category: Significant Discrepancy, Predicted Anomaly: Yes."
1,1619205,46821,21882,24939,Break,Significant Discrepancy,1,"Company: 1, Account: 1619205, GL Balance: 46821, IHub Balance: 21882, Balance Difference: 24939, Match Status: Break, Discrepancy Category: Significant Discrepancy, Predicted Anomaly: Yes."
2,1619205,47941,32024,15917,Break,Significant Discrepancy,1,"Company: 2, Account: 1619205, GL Balance: 47941, IHub Balance: 32024, Balance Difference: 15917, Match Status: Break, Discrepancy Category: Significant Discrepancy, Predicted Anomaly: Yes."
3,1619205,35570,84519,-48949,Break,Significant Discrepancy,1,"Company: 3, Account: 1619205, GL Balance: 35570, IHub Balance: 84519, Balance Difference: -48949, Match Status: Break, Discrepancy Category: Significant Discrepancy, Predicted Anomaly: Yes."
1,1619205,90720,19475,71245,Break,Significant Discrepancy,1,"Company: 1, Account: 1619205, GL Balance: 90720, IHub Balance: 19475, Balance Difference: 71245, Match Status: Break, Discrepancy Category: Significant Discrepancy, Predicted Anomaly: Yes."
2,1619205,65283,19386,45897,Break,Significant Discrepancy,1,"Company: 2, Account: 1619205, GL Balance: 65283, IHub Balance: 19386, Balance Difference: 45897, Match Status: Break, Discrepancy Category: Significant Discrepancy, Predicted Anomaly: Yes."
3,1619205,37632,76267,-38635,Break,Significant Discrepancy,1,"Company: 3, Account: 1619205, GL Balance: 37632, IHub Balance: 76267, Balance Difference: -38635, Match Status: Break, Discrepancy Category: Significant Discrepancy, Predicted Anomaly: Yes."
2,1619205,75936,65184,10752,Break,Significant Discrepancy,1,"Company: 2, Account: 1619205, GL Balance: 75936, IHub Balance: 65184, Balance Difference: 10752, Match Status: Break, Discrepancy Category: Significant Discrepancy, Predicted Anomaly: Yes."
1,1619205,81309,61672,19637,Break,Significant Discrepancy,1,"Company: 1, Account: 1619205, GL Balance: 81309, IHub Balance: 61672, Balance Difference: 19637, Match Status: Break, Discrepancy Category: Significant Discrepancy, Predicted Anomaly: Yes."
3,1619205,90770,33212,57558,Break,Significant Discrepancy,1,"Company: 3, Account: 1619205, GL Balance: 90770, IHub Balance: 33212, Balance Difference: 57558, Match Status: Break, Discrepancy Category: Significant Discrepancy, Predicted Anomaly: Yes."
3,1619205,45969,97889,-51920,Break,Significant Discrepancy,1,"Company: 3, Account: 1619205, GL Balance: 45969, IHub Balance: 97889, Balance Difference: -51920, Match Status: Break, Discrepancy Category: Significant Discrepancy, Predicted Anomaly: Yes."
2,1619205,11789,27573,-15784,Break,Significant Discrepancy,1,"Company: 2, Account: 1619205, GL Balance: 11789, IHub Balance: 27573, Balance Difference: -15784, Match Status: Break, Discrepancy Category: Significant Discrepancy, Predicted Anomaly: Yes."
3,1619205,79103,82959,-3856,Break,Significant Discrepancy,1,"Company: 3, Account: 1619205, GL Balance: 79103, IHub Balance: 82959, Balance Difference: -3856, Match Status: Break, Discrepancy Category: Significant Discrepancy, Predicted Anomaly: Yes."
1,1619205,95283,89409,5874,Break,Significant Discrepancy,1,"Company: 1, Account: 1619205, GL Balance: 95283, IHub Balance: 89409, Balance Difference: 5874, Match Status: Break, Discrepancy Category: Significant Discrepancy, Predicted Anomaly: Yes."
3,1619205,16772,51340,-34568,Break,Significant Discrepancy,1,"Company: 3, Account: 1619205, GL Balance: 16772, IHub Balance: 51340, Balance Difference: -34568, Match Status: Break, Discrepancy Category: Significant Discrepancy, Predicted Anomaly: Yes."
1,1619283,32369,39765,-7396,Break,Significant Discrepancy,1,"Company: 1, Account: 1619283, GL Balance: 32369, IHub Balance: 39765, Balance Difference: -7396, Match Status: Break, Discrepancy Category: Significant Discrepancy, Predicted Anomaly: Yes."
3,1619283,13196,15241,-2045,Break,Significant Discrepancy,1,"Company: 3, Account: 1619283, GL Balance: 13196, IHub Balance: 15241, Balance Difference: -2045, Match Status: Break, Discrepancy Category: Significant Discrepancy, Predicted Anomaly: Yes."
1,1619283,93346,85430,7916,Break,Significant Discrepancy,1,"Company: 1, Account: 1619283, GL Balance: 93346, IHub Balance: 85430, Balance Difference: 7916, Match Status: Break, Discrepancy Category: Significant Discrepancy, Predicted Anomaly: Yes."
3,1619283,31605,47909,-16304,Break,Significant Discrepancy,1,"Company: 3, Account: 1619283, GL Balance: 31605, IHub Balance: 47909, Balance Difference: -16304, Match Status: Break, Discrepancy Category: Significant Discrepancy, Predicted Anomaly: Yes."
1,1619283,76945,95024,-18079,Break,Significant Discrepancy,1,"Company: 1, Account: 1619283, GL Balance: 76945, IHub Balance: 95024, Balance Difference: -18079, Match Status: Break, Discrepancy Category: Significant Discrepancy, Predicted Anomaly: Yes."
1,1619283,65355,33365,31990,Break,Significant Discrepancy,1,"Company: 1, Account: 1619283, GL Balance: 65355, IHub Balance: 33365, Balance Difference: 31990, Match Status: Break, Discrepancy Category: Significant Discrepancy, Predicted Anomaly: Yes."
2,1619283,63517,48712,14805,Break,Significant Discrepancy,1,"Company: 2, Account: 1619283, GL Balance: 63517, IHub Balance: 48712, Balance Difference: 14805, Match Status: Break, Discrepancy Category: Significant Discrepancy, Predicted Anomaly: Yes."
1,1619283,60986,62134,-1148,Break,Significant Discrepancy,1,"Company: 1, Account: 1619283, GL Balance: 60986, IHub Balance: 62134, Balance Difference: -1148, Match Status: Break, Discrepancy Category: Significant Discrepancy, Predicted Anomaly: Yes."
3,1619283,54135,22076,32059,Break,Significant Discrepancy,1,"Company: 3, Account: 1619283, GL Balance: 54135, IHub Balance: 22076, Balance Difference: 32059, Match Status: Break, Discrepancy Category: Significant Discrepancy, Predicted Anomaly: Yes."
2,1619283,25248,93509,-68261,Break,Significant Discrepancy,1,"Company: 2, Account: 1619283, GL Balance: 25248, IHub Balance: 93509, Balance Difference: -68261, Match Status: Break, Discrepancy Category: Significant Discrepancy, Predicted Anomaly: Yes."
3,1619283,53205,42705,10500,Break,Significant Discrepancy,1,"Company: 3, Account: 1619283, GL Balance: 53205, IHub Balance: 42705, Balance Difference: 10500, Match Status: Break, Discrepancy Category: Significant Discrepancy, Predicted Anomaly: Yes."
2,1619283,73295,82908,-9613,Break,Significant Discrepancy,1,"Company: 2, Account: 1619283, GL Balance: 73295, IHub Balance: 82908, Balance Difference: -9613, Match Status: Break, Discrepancy Category: Significant Discrepancy, Predicted Anomaly: Yes."
2,1619283,45950,44262,1688,Break,Significant Discrepancy,1,"Company: 2, Account: 1619283, GL Balance: 45950, IHub Balance: 44262, Balance Difference: 1688, Match Status: Break, Discrepancy Category: Significant Discrepancy, Predicted Anomaly: Yes."
3,1619283,48598,41645,6953,Break,Significant Discrepancy,1,"Company: 3, Account: 1619283, GL Balance: 48598, IHub Balance: 41645, Balance Difference: 6953, Match Status: Break, Discrepancy Category: Significant Discrepancy, Predicted Anomaly: Yes."
2,1619283,90758,50983,39775,Break,Significant Discrepancy,1,"Company: 2, Account: 1619283, GL Balance: 90758, IHub Balance: 50983, Balance Difference: 39775, Match Status: Break, Discrepancy Category: Significant Discrepancy, Predicted Anomaly: Yes."
1,1619283,35761,49159,-13398,Break,Significant Discrepancy,1,"Company: 1, Account: 1619283, GL Balance: 35761, IHub Balance: 49159, Balance Difference: -13398, Match Status: Break, Discrepancy Category: Significant Discrepancy, Predicted Anomaly: Yes."
1,1619283,46159,86256,-40097,Break,Significant Discrepancy,1,"Company: 1, Account: 1619283, GL Balance: 46159, IHub Balance: 86256, Balance Difference: -40097, Match Status: Break, Discrepancy Category: Significant Discrepancy, Predicted Anomaly: Yes."
3,1619283,88894,51792,37102,Break,Significant Discrepancy,1,"Company: 3, Account: 1619283, GL Balance: 88894, IHub Balance: 51792, Balance Difference: 37102, Match Status: Break, Discrepancy Category: Significant Discrepancy, Predicted Anomaly: Yes."
3,1619283,93106,53626,39480,Break,Significant Discrepancy,1,"Company: 3, Account: 1619283, GL Balance: 93106, IHub Balance: 53626, Balance Difference: 39480, Match Status: Break, Discrepancy Category: Significant Discrepancy, Predicted Anomaly: Yes."
2,1619283,23092,63739,-40647,Break,Significant Discrepancy,1,"Company: 2, Account: 1619283, GL Balance: 23092, IHub Balance: 63739, Balance Difference: -40647, Match Status: Break, Discrepancy Category: Significant Discrepancy, Predicted Anomaly: Yes."
2,1619283,28847,78945,-50098,Break,Significant Discrepancy,1,"Company: 2, Account: 1619283, GL Balance: 28847, IHub Balance: 78945, Balance Difference: -50098, Match Status: Break, Discrepancy Category: Significant Discrepancy, Predicted Anomaly: Yes."
3,1619283,15435,99493,-84058,Break,Significant Discrepancy,1,"Company: 3, Account: 1619283, GL Balance: 15435, IHub Balance: 99493, Balance Difference: -84058, Match Status: Break, Discrepancy Category: Significant Discrepancy, Predicted Anomaly: Yes."
2,1619283,97793,40990,56803,Break,Significant Discrepancy,1,"Company: 2, Account: 1619283, GL Balance: 97793, IHub Balance: 40990, Balance Difference: 56803, Match Status: Break, Discrepancy Category: Significant Discrepancy, Predicted Anomaly: Yes."
1,1619283,70194,11115,59079,Break,Significant Discrepancy,1,"Company: 1, Account: 1619283, GL Balance: 70194, IHub Balance: 11115, Balance Difference: 59079, Match Status: Break, Discrepancy Category: Significant Discrepancy, Predicted Anomaly: Yes."
3,1619283,83746,60192,23554,Break,Significant Discrepancy,1,"Company: 3, Account: 1619283, GL Balance: 83746, IHub Balance: 60192, Balance Difference: 23554, Match Status: Break, Discrepancy Category: Significant Discrepancy, Predicted Anomaly: Yes."
3,1619283,44012,75277,-31265,Break,Significant Discrepancy,1,"Company: 3, Account: 1619283, GL Balance: 44012, IHub Balance: 75277, Balance Difference: -31265, Match Status: Break, Discrepancy Category: Significant Discrepancy, Predicted Anomaly: Yes."
3,1619283,99506,40020,59486,Break,Significant Discrepancy,1,"Company: 3, Account: 1619283, GL Balance: 99506, IHub Balance: 40020, Balance Difference: 59486, Match Status: Break, Discrepancy Category: Significant Discrepancy, Predicted Anomaly: Yes."
3,1619283,33296,33039,257,Match,Other,0,"Company: 3, Account: 1619283, GL Balance: 33296, IHub Balance: 33039, Balance Difference: 257, Match Status: Match, Discrepancy Category: Other, Predicted Anomaly: No."
3,1619283,66095,67199,-1104,Break,Significant Discrepancy,1,"Company: 3, Account: 1619283, GL Balance: 66095, IHub Balance: 67199, Balance Difference: -1104, Match Status: Break, Discrepancy Category: Significant Discrepancy, Predicted Anomaly: Yes."
3,1619283,75792,80690,-4898,Break,Significant Discrepancy,1,"Company: 3, Account: 1619283, GL Balance: 75792, IHub Balance: 80690, Balance Difference: -4898, Match Status: Break, Discrepancy Category: Significant Discrepancy, Predicted Anomaly: Yes."
3,1619283,24915,83745,-58830,Break,Significant Discrepancy,1,"Company: 3, Account: 1619283, GL Balance: 24915, IHub Balance: 83745, Balance Difference: -58830, Match Status: Break, Discrepancy Category: Significant Discrepancy, Predicted Anomaly: Yes."
3,1619283,65673,55802,9871,Break,Significant Discrepancy,1,"Company: 3, Account: 1619283, GL Balance: 65673, IHub Balance: 55802, Balance Difference: 9871, Match Status: Break, Discrepancy Category: Significant Discrepancy, Predicted Anomaly: Yes."
3,1619283,63260,94106,-30846,Break,Significant Discrepancy,1,"Company: 3, Account: 1619283, GL Balance: 63260, IHub Balance: 94106, Balance Difference: -30846, Match Status: Break, Discrepancy Category: Significant Discrepancy, Predicted Anomaly: Yes."
2,1619283,69056,42975,26081,Break,Significant Discrepancy,1,"Company: 2, Account: 1619283, GL Balance: 69056, IHub Balance: 42975, Balance Difference: 26081, Match Status: Break, Discrepancy Category: Significant Discrepancy, Predicted Anomaly: Yes."
2,1619283,45282,22975,22307,Break,Significant Discrepancy,1,"Company: 2, Account: 1619283, GL Balance: 45282, IHub Balance: 22975, Balance Difference: 22307, Match Status: Break, Discrepancy Category: Significant Discrepancy, Predicted Anomaly: Yes."
3,1619283,38261,14102,24159,Break,Significant Discrepancy,1,"Company: 3, Account: 1619283, GL Balance: 38261, IHub Balance: 14102, Balance Difference: 24159, Match Status: Break, Discrepancy Category: Significant Discrepancy, Predicted Anomaly: Yes."
3,1619283,32694,78943,-46249,Break,Significant Discrepancy,1,"Company: 3, Account: 1619283, GL Balance: 32694, IHub Balance: 78943, Balance Difference: -46249, Match Status: Break, Discrepancy Category: Significant Discrepancy, Predicted Anomaly: Yes."
1,1619283,82572,24908,57664,Break,Significant Discrepancy,1,"Company: 1, Account: 1619283, GL Balance: 82572, IHub Balance: 24908, Balance Difference: 57664, Match Status: Break, Discrepancy Category: Significant Discrepancy, Predicted Anomaly: Yes."
2,1619283,39047,29924,9123,Break,Significant Discrepancy,1,"Company: 2, Account: 1619283, GL Balance: 39047, IHub Balance: 29924, Balance Difference: 9123, Match Status: Break, Discrepancy Category: Significant Discrepancy, Predicted Anomaly: Yes."
2,1619283,92269,14535,77734,Break,Significant Discrepancy,1,"Company: 2, Account: 1619283, GL Balance: 92269, IHub Balance: 14535, Balance Difference: 77734, Match Status: Break, Discrepancy Category: Significant Discrepancy, Predicted Anomaly: Yes."
3,1619283,61883,77507,-15624,Break,Significant Discrepancy,1,"Company: 3, Account: 1619283, GL Balance: 61883, IHub Balance: 77507, Balance Difference: -15624, Match Status: Break, Discrepancy Category: Significant Discrepancy, Predicted Anomaly: Yes."
3,1619283,76691,79519,-2828,Break,Significant Discrepancy,1,"Company: 3, Account: 1619283, GL Balance: 76691, IHub Balance: 79519, Balance Difference: -2828, Match Status: Break, Discrepancy Category: Significant Discrepancy, Predicted Anomaly: Yes."
1,1619283,40628,61999,-21371,Break,Significant Discrepancy,1,"Company: 1, Account: 1619283, GL Balance: 40628, IHub Balance: 61999, Balance Difference: -21371, Match Status: Break, Discrepancy Category: Significant Discrepancy, Predicted Anomaly: Yes."
1,1619283,42449,66035,-23586,Break,Significant Discrepancy,1,"Company: 1, Account: 1619283, GL Balance: 42449, IHub Balance: 66035, Balance Difference: -23586, Match Status: Break, Discrepancy Category: Significant Discrepancy, Predicted Anomaly: Yes."
2,1619283,62186,62635,-449,Match,Other,0,"Company: 2, Account: 1619283, GL Balance: 62186, IHub Balance: 62635, Balance Difference: -449, Match Status: Match, Discrepancy Category: Other, Predicted Anomaly: No."
1,1619283,11725,31604,-19879,Break,Significant Discrepancy,1,"Company: 1, Account: 1619283, GL Balance: 11725, IHub Balance: 31604, Balance Difference: -19879, Match Status: Break, Discrepancy Category: Significant Discrepancy, Predicted Anomaly: Yes."
2,1619283,76400,19834,56566,Break,Significant Discrepancy,1,"Company: 2, Account: 1619283, GL Balance: 76400, IHub Balance: 19834, Balance Difference: 56566, Match Status: Break, Discrepancy Category: Significant Discrepancy, Predicted Anomaly: Yes."
1,1619283,14477,70261,-55784,Break,Significant Discrepancy,1,"Company: 1, Account: 1619283, GL Balance: 14477, IHub Balance: 70261, Balance Difference: -55784, Match Status: Break, Discrepancy Category: Significant Discrepancy, Predicted Anomaly: Yes."
1,1619283,11587,29116,-17529,Break,Significant Discrepancy,1,"Company: 1, Account: 1619283, GL Balance: 11587, IHub Balance: 29116, Balance Difference: -17529, Match Status: Break, Discrepancy Category: Significant Discrepancy, Predicted Anomaly: Yes."
2,1619283,32745,74892,-42147,Break,Significant Discrepancy,1,"Company: 2, Account: 1619283, GL Balance: 32745, IHub Balance: 74892, Balance Difference: -42147, Match Status: Break, Discrepancy Category: Significant Discrepancy, Predicted Anomaly: Yes."
3,1619283,10865,25522,-14657,Break,Significant Discrepancy,1,"Company: 3, Account: 1619283, GL Balance: 10865, IHub Balance: 25522, Balance Difference: -14657, Match Status: Break, Discrepancy Category: Significant Discrepancy, Predicted Anomaly: Yes."
1,1619283,21173,84034,-62861,Break,Significant Discrepancy,1,"Company: 1, Account: 1619283, GL Balance: 21173, IHub Balance: 84034, Balance Difference: -62861, Match Status: Break, Discrepancy Category: Significant Discrepancy, Predicted Anomaly: Yes."
3,1619283,61248,57994,3254,Break,Significant Discrepancy,1,"Company: 3, Account: 1619283, GL Balance: 61248, IHub Balance: 57994, Balance Difference: 3254, Match Status: Break, Discrepancy Category: Significant Discrepancy, Predicted Anomaly: Yes."
1,1619283,48174,98743,-50569,Break,Significant Discrepancy,1,"Company: 1, Account: 1619283, GL Balance: 48174, IHub Balance: 98743, Balance Difference: -50569, Match Status: Break, Discrepancy Category: Significant Discrepancy, Predicted Anomaly: Yes."
2,1619283,13203,37007,-23804,Break,Significant Discrepancy,1,"Company: 2, Account: 1619283, GL Balance: 13203, IHub Balance: 37007, Balance Difference: -23804, Match Status: Break, Discrepancy Category: Significant Discrepancy, Predicted Anomaly: Yes."
2,1619283,48374,56514,-8140,Break,Significant Discrepancy,1,"Company: 2, Account: 1619283, GL Balance: 48374, IHub Balance: 56514, Balance Difference: -8140, Match Status: Break, Discrepancy Category: Significant Discrepancy, Predicted Anomaly: Yes."
2,1619283,22041,88287,-66246,Break,Significant Discrepancy,1,"Company: 2, Account: 1619283, GL Balance: 22041, IHub Balance: 88287, Balance Difference: -66246, Match Status: Break, Discrepancy Category: Significant Discrepancy, Predicted Anomaly: Yes."
3,1619283,94500,30108,64392,Break,Significant Discrepancy,1,"Company: 3, Account: 1619283, GL Balance: 94500, IHub Balance: 30108, Balance Difference: 64392, Match Status: Break, Discrepancy Category: Significant Discrepancy, Predicted Anomaly: Yes."
2,1619283,91686,75206,16480,Break,Significant Discrepancy,1,"Company: 2, Account: 1619283, GL Balance: 91686, IHub Balance: 75206, Balance Difference: 16480, Match Status: Break, Discrepancy Category: Significant Discrepancy, Predicted Anomaly: Yes."
1,1619283,32620,38024,-5404,Break,Significant Discrepancy,1,"Company: 1, Account: 1619283, GL Balance: 32620, IHub Balance: 38024, Balance Difference: -5404, Match Status: Break, Discrepancy Category: Significant Discrepancy, Predicted Anomaly: Yes."
2,1619283,15322,55708,-40386,Break,Significant Discrepancy,1,"Company: 2, Account: 1619283, GL Balance: 15322, IHub Balance: 55708, Balance Difference: -40386, Match Status: Break, Discrepancy Category: Significant Discrepancy, Predicted Anomaly: Yes."
1,1619283,46169,37757,8412,Break,Significant Discrepancy,1,"Company: 1, Account: 1619283, GL Balance: 46169, IHub Balance: 37757, Balance Difference: 8412, Match Status: Break, Discrepancy Category: Significant Discrepancy, Predicted Anomaly: Yes."
2,1619283,35287,41250,-5963,Break,Significant Discrepancy,1,"Company: 2, Account: 1619283, GL Balance: 35287, IHub Balance: 41250, Balance Difference: -5963, Match Status: Break, Discrepancy Category: Significant Discrepancy, Predicted Anomaly: Yes."
2,1619283,97359,48562,48797,Break,Significant Discrepancy,1,"Company: 2, Account: 1619283, GL Balance: 97359, IHub Balance: 48562, Balance Difference: 48797, Match Status: Break, Discrepancy Category: Significant Discrepancy, Predicted Anomaly: Yes."
3,1619283,58825,12580,46245,Break,Significant Discrepancy,1,"Company: 3, Account: 1619283, GL Balance: 58825, IHub Balance: 12580, Balance Difference: 46245, Match Status: Break, Discrepancy Category: Significant Discrepancy, Predicted Anomaly: Yes."
1,1619283,85591,84791,800,Match,Other,0,"Company: 1, Account: 1619283, GL Balance: 85591, IHub Balance: 84791, Balance Difference: 800, Match Status: Match, Discrepancy Category: Other, Predicted Anomaly: No."
2,1619283,32391,99336,-66945,Break,Significant Discrepancy,1,"Company: 2, Account: 1619283, GL Balance: 32391, IHub Balance: 99336, Balance Difference: -66945, Match Status: Break, Discrepancy Category: Significant Discrepancy, Predicted Anomaly: Yes."
1,1619283,49465,10671,38794,Break,Significant Discrepancy,1,"Company: 1, Account: 1619283, GL Balance: 49465, IHub Balance: 10671, Balance Difference: 38794, Match Status: Break, Discrepancy Category: Significant Discrepancy, Predicted Anomaly: Yes."
3,1619283,44077,94101,-50024,Break,Significant Discrepancy,1,"Company: 3, Account: 1619283, GL Balance: 44077, IHub Balance: 94101, Balance Difference: -50024, Match Status: Break, Discrepancy Category: Significant Discrepancy, Predicted Anomaly: Yes."
1,1619283,90865,16806,74059,Break,Significant Discrepancy,1,"Company: 1, Account: 1619283, GL Balance: 90865, IHub Balance: 16806, Balance Difference: 74059, Match Status: Break, Discrepancy Category: Significant Discrepancy, Predicted Anomaly: Yes."
2,1619283,55371,26978,28393,Break,Significant Discrepancy,1,"Company: 2, Account: 1619283, GL Balance: 55371, IHub Balance: 26978, Balance Difference: 28393, Match Status: Break, Discrepancy Category: Significant Discrepancy, Predicted Anomaly: Yes."
3,1619283,78295,37703,40592,Break,Significant Discrepancy,1,"Company: 3, Account: 1619283, GL Balance: 78295, IHub Balance: 37703, Balance Difference: 40592, Match Status: Break, Discrepancy Category: Significant Discrepancy, Predicted Anomaly: Yes."
1,1619283,36205,26630,9575,Break,Significant Discrepancy,1,"Company: 1, Account: 1619283, GL Balance: 36205, IHub Balance: 26630, Balance Difference: 9575, Match Status: Break, Discrepancy Category: Significant Discrepancy, Predicted Anomaly: Yes."
3,1619283,16475,86452,-69977,Break,Significant Discrepancy,1,"Company: 3, Account: 1619283, GL Balance: 16475, IHub Balance: 86452, Balance Difference: -69977, Match Status: Break, Discrepancy Category: Significant Discrepancy, Predicted Anomaly: Yes."
1,1619283,43513,34154,9359,Break,Significant Discrepancy,1,"Company: 1, Account: 1619283, GL Balance: 43513, IHub Balance: 34154, Balance Difference: 9359, Match Status: Break, Discrepancy Category: Significant Discrepancy, Predicted Anomaly: Yes."
2,1619283,97228,14008,83220,Break,Significant Discrepancy,1,"Company: 2, Account: 1619283, GL Balance: 97228, IHub Balance: 14008, Balance Difference: 83220, Match Status: Break, Discrepancy Category: Significant Discrepancy, Predicted Anomaly: Yes."
2,1619283,22397,27790,-5393,Break,Significant Discrepancy,1,"Company: 2, Account: 1619283, GL Balance: 22397, IHub Balance: 27790, Balance Difference: -5393, Match Status: Break, Discrepancy Category: Significant Discrepancy, Predicted Anomaly: Yes."
1,1619283,21415,59632,-38217,Break,Significant Discrepancy,1,"Company: 1, Account: 1619283, GL Balance: 21415, IHub Balance: 59632, Balance Difference: -38217, Match Status: Break, Discrepancy Category: Significant Discrepancy, Predicted Anomaly: Yes."
2,1619283,47289,17973,29316,Break,Significant Discrepancy,1,"Company: 2, Account: 1619283, GL Balance: 47289, IHub Balance: 17973, Balance Difference: 29316, Match Status: Break, Discrepancy Category: Significant Discrepancy, Predicted Anomaly: Yes."
2,1619283,91081,30714,60367,Break,Significant Discrepancy,1,"Company: 2, Account: 1619283, GL Balance: 91081, IHub Balance: 30714, Balance Difference: 60367, Match Status: Break, Discrepancy Category: Significant Discrepancy, Predicted Anomaly: Yes."
1,1619283,20447,66782,-46335,Break,Significant Discrepancy,1,"Company: 1, Account: 1619283, GL Balance: 20447, IHub Balance: 66782, Balance Difference: -46335, Match Status: Break, Discrepancy Category: Significant Discrepancy, Predicted Anomaly: Yes."
3,1619283,70107,20073,50034,Break,Significant Discrepancy,1,"Company: 3, Account: 1619283, GL Balance: 70107, IHub Balance: 20073, Balance Difference: 50034, Match Status: Break, Discrepancy Category: Significant Discrepancy, Predicted Anomaly: Yes."
2,1619283,60762,74094,-13332,Break,Significant Discrepancy,1,"Company: 2, Account: 1619283, GL Balance: 60762, IHub Balance: 74094, Balance Difference: -13332, Match Status: Break, Discrepancy Category: Significant Discrepancy, Predicted Anomaly: Yes."
3,1619283,20839,50180,-29341,Break,Significant Discrepancy,1,"Company: 3, Account: 1619283, GL Balance: 20839, IHub Balance: 50180, Balance Difference: -29341, Match Status: Break, Discrepancy Category: Significant Discrepancy, Predicted Anomaly: Yes."
1,1619283,82682,48034,34648,Break,Significant Discrepancy,1,"Company: 1, Account: 1619283, GL Balance: 82682, IHub Balance: 48034, Balance Difference: 34648, Match Status: Break, Discrepancy Category: Significant Discrepancy, Predicted Anomaly: Yes."
3,1619283,33762,21545,12217,Break,Significant Discrepancy,1,"Company: 3, Account: 1619283, GL Balance: 33762, IHub Balance: 21545, Balance Difference: 12217, Match Status: Break, Discrepancy Category: Significant Discrepancy, Predicted Anomaly: Yes."
3,1619283,46558,43359,3199,Break,Significant Discrepancy,1,"Company: 3, Account: 1619283, GL Balance: 46558, IHub Balance: 43359, Balance Difference: 3199, Match Status: Break, Discrepancy Category: Significant Discrepancy, Predicted Anomaly: Yes."
1,1619283,32553,61012,-28459,Break,Significant Discrepancy,1,"Company: 1, Account: 1619283, GL Balance: 32553, IHub Balance: 61012, Balance Difference: -28459, Match Status: Break, Discrepancy Category: Significant Discrepancy, Predicted Anomaly: Yes."
3,1619283,50969,61786,-10817,Break,Significant Discrepancy,1,"Company: 3, Account: 1619283, GL Balance: 50969, IHub Balance: 61786, Balance Difference: -10817, Match Status: Break, Discrepancy Category: Significant Discrepancy, Predicted Anomaly: Yes."
1,1619283,45645,36707,8938,Break,Significant Discrepancy,1,"Company: 1, Account: 1619283, GL Balance: 45645, IHub Balance: 36707, Balance Difference: 8938, Match Status: Break, Discrepancy Category: Significant Discrepancy, Predicted Anomaly: Yes."
1,1619283,97483,52459,45024,Break,Significant Discrepancy,1,"Company: 1, Account: 1619283, GL Balance: 97483, IHub Balance: 52459, Balance Difference: 45024, Match Status: Break, Discrepancy Category: Significant Discrepancy, Predicted Anomaly: Yes."
2,1619283,78187,78771,-584,Match,Other,0,"Company: 2, Account: 1619283, GL Balance: 78187, IHub Balance: 78771, Balance Difference: -584, Match Status: Match, Discrepancy Category: Other, Predicted Anomaly: No."
1,1619283,25248,54871,-29623,Break,Significant Discrepancy,1,"Company: 1, Account: 1619283, GL Balance: 25248, IHub Balance: 54871, Balance Difference: -29623, Match Status: Break, Discrepancy Category: Significant Discrepancy, Predicted Anomaly: Yes."
2,1619283,28263,45877,-17614,Break,Significant Discrepancy,1,"Company: 2, Account: 1619283, GL Balance: 28263, IHub Balance: 45877, Balance Difference: -17614, Match Status: Break, Discrepancy Category: Significant Discrepancy, Predicted Anomaly: Yes."
3,1619283,57176,17942,39234,Break,Significant Discrepancy,1,"Company: 3, Account: 1619283, GL Balance: 57176, IHub Balance: 17942, Balance Difference: 39234, Match Status: Break, Discrepancy Category: Significant Discrepancy, Predicted Anomaly: Yes."
3,1619283,60231,72451,-12220,Break,Significant Discrepancy,1,"Company: 3, Account: 1619283, GL Balance: 60231, IHub Balance: 72451, Balance Difference: -12220, Match Status: Break, Discrepancy Category: Significant Discrepancy, Predicted Anomaly: Yes."
3,1619283,21162,80819,-59657,Break,Significant Discrepancy,1,"Company: 3, Account: 1619283, GL Balance: 21162, IHub Balance: 80819, Balance Difference: -59657, Match Status: Break, Discrepancy Category: Significant Discrepancy, Predicted Anomaly: Yes."
3,1619283,57279,22780,34499,Break,Significant Discrepancy,1,"Company: 3, Account: 1619283, GL Balance: 57279, IHub Balance: 22780, Balance Difference: 34499, Match Status: Break, Discrepancy Category: Significant Discrepancy, Predicted Anomaly: Yes."
2,1619283,76205,88414,-12209,Break,Significant Discrepancy,1,"Company: 2, Account: 1619283, GL Balance: 76205, IHub Balance: 88414, Balance Difference: -12209, Match Status: Break, Discrepancy Category: Significant Discrepancy, Predicted Anomaly: Yes."
3,1619283,28890,78258,-49368,Break,Significant Discrepancy,1,"Company: 3, Account: 1619283, GL Balance: 28890, IHub Balance: 78258, Balance Difference: -49368, Match Status: Break, Discrepancy Category: Significant Discrepancy, Predicted Anomaly: Yes."
1,1619283,88322,73308,15014,Break,Significant Discrepancy,1,"Company: 1, Account: 1619283, GL Balance: 88322, IHub Balance: 73308, Balance Difference: 15014, Match Status: Break, Discrepancy Category: Significant Discrepancy, Predicted Anomaly: Yes."
3,1619283,29797,38930,-9133,Break,Significant Discrepancy,1,"Company: 3, Account: 1619283, GL Balance: 29797, IHub Balance: 38930, Balance Difference: -9133, Match Status: Break, Discrepancy Category: Significant Discrepancy, Predicted Anomaly: Yes."
3,1619283,81688,91144,-9456,Break,Significant Discrepancy,1,"Company: 3, Account: 1619283, GL Balance: 81688, IHub Balance: 91144, Balance Difference: -9456, Match Status: Break, Discrepancy Category: Significant Discrepancy, Predicted Anomaly: Yes."
2,1619283,66235,20207,46028,Break,Significant Discrepancy,1,"Company: 2, Account: 1619283, GL Balance: 66235, IHub Balance: 20207, Balance Difference: 46028, Match Status: Break, Discrepancy Category: Significant Discrepancy, Predicted Anomaly: Yes."
3,1619283,26682,81437,-54755,Break,Significant Discrepancy,1,"Company: 3, Account: 1619283, GL Balance: 26682, IHub Balance: 81437, Balance Difference: -54755, Match Status: Break, Discrepancy Category: Significant Discrepancy, Predicted Anomaly: Yes."
2,1619283,80102,91371,-11269,Break,Significant Discrepancy,1,"Company: 2, Account: 1619283, GL Balance: 80102, IHub Balance: 91371, Balance Difference: -11269, Match Status: Break, Discrepancy Category: Significant Discrepancy, Predicted Anomaly: Yes."
2,1619283,56193,14761,41432,Break,Significant Discrepancy,1,"Company: 2, Account: 1619283, GL Balance: 56193, IHub Balance: 14761, Balance Difference: 41432, Match Status: Break, Discrepancy Category: Significant Discrepancy, Predicted Anomaly: Yes."
2,1619283,51615,35117,16498,Break,Significant Discrepancy,1,"Company: 2, Account: 1619283, GL Balance: 51615, IHub Balance: 35117, Balance Difference: 16498, Match Status: Break, Discrepancy Category: Significant Discrepancy, Predicted Anomaly: Yes."
1,1619283,29381,22109,7272,Break,Significant Discrepancy,1,"Company: 1, Account: 1619283, GL Balance: 29381, IHub Balance: 22109, Balance Difference: 7272, Match Status: Break, Discrepancy Category: Significant Discrepancy, Predicted Anomaly: Yes."
3,1619283,67138,19884,47254,Break,Significant Discrepancy,1,"Company: 3, Account: 1619283, GL Balance: 67138, IHub Balance: 19884, Balance Difference: 47254, Match Status: Break, Discrepancy Category: Significant Discrepancy, Predicted Anomaly: Yes."
2,1619283,62137,76920,-14783,Break,Significant Discrepancy,1,"Company: 2, Account: 1619283, GL Balance: 62137, IHub Balance: 76920, Balance Difference: -14783, Match Status: Break, Discrepancy Category: Significant Discrepancy, Predicted Anomaly: Yes."
2,1619283,31686,30478,1208,Break,Significant Discrepancy,1,"Company: 2, Account: 1619283, GL Balance: 31686, IHub Balance: 30478, Balance Difference: 1208, Match Status: Break, Discrepancy Category: Significant Discrepancy, Predicted Anomaly: Yes."
1,1619283,79918,84489,-4571,Break,Significant Discrepancy,1,"Company: 1, Account: 1619283, GL Balance: 79918, IHub Balance: 84489, Balance Difference: -4571, Match Status: Break, Discrepancy Category: Significant Discrepancy, Predicted Anomaly: Yes."
1,1619283,82918,11756,71162,Break,Significant Discrepancy,1,"Company: 1, Account: 1619283, GL Balance: 82918, IHub Balance: 11756, Balance Difference: 71162, Match Status: Break, Discrepancy Category: Significant Discrepancy, Predicted Anomaly: Yes."
2,1619283,54433,57573,-3140,Break,Significant Discrepancy,1,"Company: 2, Account: 1619283, GL Balance: 54433, IHub Balance: 57573, Balance Difference: -3140, Match Status: Break, Discrepancy Category: Significant Discrepancy, Predicted Anomaly: Yes."
2,1619283,88097,69980,18117,Break,Significant Discrepancy,1,"Company: 2, Account: 1619283, GL Balance: 88097, IHub Balance: 69980, Balance Difference: 18117, Match Status: Break, Discrepancy Category: Significant Discrepancy, Predicted Anomaly: Yes."
2,1619283,37862,52865,-15003,Break,Significant Discrepancy,1,"Company: 2, Account: 1619283, GL Balance: 37862, IHub Balance: 52865, Balance Difference: -15003, Match Status: Break, Discrepancy Category: Significant Discrepancy, Predicted Anomaly: Yes."
3,1619283,48677,64304,-15627,Break,Significant Discrepancy,1,"Company: 3, Account: 1619283, GL Balance: 48677, IHub Balance: 64304, Balance Difference: -15627, Match Status: Break, Discrepancy Category: Significant Discrepancy, Predicted Anomaly: Yes."
1,1619283,30460,60481,-30021,Break,Significant Discrepancy,1,"Company: 1, Account: 1619283, GL Balance: 30460, IHub Balance: 60481, Balance Difference: -30021, Match Status: Break, Discrepancy Category: Significant Discrepancy, Predicted Anomaly: Yes."
2,1619283,82302,43979,38323,Break,Significant Discrepancy,1,"Company: 2, Account: 1619283, GL Balance: 82302, IHub Balance: 43979, Balance Difference: 38323, Match Status: Break, Discrepancy Category: Significant Discrepancy, Predicted Anomaly: Yes."
3,1619283,39299,45794,-6495,Break,Significant Discrepancy,1,"Company: 3, Account: 1619283, GL Balance: 39299, IHub Balance: 45794, Balance Difference: -6495, Match Status: Break, Discrepancy Category: Significant Discrepancy, Predicted Anomaly: Yes."
3,1619283,80864,91701,-10837,Break,Significant Discrepancy,1,"Company: 3, Account: 1619283, GL Balance: 80864, IHub Balance: 91701, Balance Difference: -10837, Match Status: Break, Discrepancy Category: Significant Discrepancy, Predicted Anomaly: Yes."
3,1619283,66893,65659,1234,Break,Significant Discrepancy,1,"Company: 3, Account: 1619283, GL Balance: 66893, IHub Balance: 65659, Balance Difference: 1234, Match Status: Break, Discrepancy Category: Significant Discrepancy, Predicted Anomaly: Yes."
3,1619283,89415,24925,64490,Break,Significant Discrepancy,1,"Company: 3, Account: 1619283, GL Balance: 89415, IHub Balance: 24925, Balance Difference: 64490, Match Status: Break, Discrepancy Category: Significant Discrepancy, Predicted Anomaly: Yes."
1,1619283,65654,46135,19519,Break,Significant Discrepancy,1,"Company: 1, Account: 1619283, GL Balance: 65654, IHub Balance: 46135, Balance Difference: 19519, Match Status: Break, Discrepancy Category: Significant Discrepancy, Predicted Anomaly: Yes."
3,1619283,80051,84947,-4896,Break,Significant Discrepancy,1,"Company: 3, Account: 1619283, GL Balance: 80051, IHub Balance: 84947, Balance Difference: -4896, Match Status: Break, Discrepancy Category: Significant Discrepancy, Predicted Anomaly: Yes."
2,1619283,27276,55482,-28206,Break,Significant Discrepancy,1,"Company: 2, Account: 1619283, GL Balance: 27276, IHub Balance: 55482, Balance Difference: -28206, Match Status: Break, Discrepancy Category: Significant Discrepancy, Predicted Anomaly: Yes."
3,1619283,27357,93661,-66304,Break,Significant Discrepancy,1,"Company: 3, Account: 1619283, GL Balance: 27357, IHub Balance: 93661, Balance Difference: -66304, Match Status: Break, Discrepancy Category: Significant Discrepancy, Predicted Anomaly: Yes."
3,1619283,34226,71707,-37481,Break,Significant Discrepancy,1,"Company: 3, Account: 1619283, GL Balance: 34226, IHub Balance: 71707, Balance Difference: -37481, Match Status: Break, Discrepancy Category: Significant Discrepancy, Predicted Anomaly: Yes."
1,1619283,89198,21695,67503,Break,Significant Discrepancy,1,"Company: 1, Account: 1619283, GL Balance: 89198, IHub Balance: 21695, Balance Difference: 67503, Match Status: Break, Discrepancy Category: Significant Discrepancy, Predicted Anomaly: Yes."
1,1619283,50477,64165,-13688,Break,Significant Discrepancy,1,"Company: 1, Account: 1619283, GL Balance: 50477, IHub Balance: 64165, Balance Difference: -13688, Match Status: Break, Discrepancy Category: Significant Discrepancy, Predicted Anomaly: Yes."
2,1619283,47606,56978,-9372,Break,Significant Discrepancy,1,"Company: 2, Account: 1619283, GL Balance: 47606, IHub Balance: 56978, Balance Difference: -9372, Match Status: Break, Discrepancy Category: Significant Discrepancy, Predicted Anomaly: Yes."
2,1619283,60621,15607,45014,Break,Significant Discrepancy,1,"Company: 2, Account: 1619283, GL Balance: 60621, IHub Balance: 15607, Balance Difference: 45014, Match Status: Break, Discrepancy Category: Significant Discrepancy, Predicted Anomaly: Yes."
1,1619283,13346,47405,-34059,Break,Significant Discrepancy,1,"Company: 1, Account: 1619283, GL Balance: 13346, IHub Balance: 47405, Balance Difference: -34059, Match Status: Break, Discrepancy Category: Significant Discrepancy, Predicted Anomaly: Yes."
1,1619283,81196,21136,60060,Break,Significant Discrepancy,1,"Company: 1, Account: 1619283, GL Balance: 81196, IHub Balance: 21136, Balance Difference: 60060, Match Status: Break, Discrepancy Category: Significant Discrepancy, Predicted Anomaly: Yes."
2,1619283,65989,66414,-425,Match,Other,0,"Company: 2, Account: 1619283, GL Balance: 65989, IHub Balance: 66414, Balance Difference: -425, Match Status: Match, Discrepancy Category: Other, Predicted Anomaly: No."
2,1619283,79672,41153,38519,Break,Significant Discrepancy,1,"Company: 2, Account: 1619283, GL Balance: 79672, IHub Balance: 41153, Balance Difference: 38519, Match Status: Break, Discrepancy Category: Significant Discrepancy, Predicted Anomaly: Yes."
1,1619283,47067,64672,-17605,Break,Significant Discrepancy,1,"Company: 1, Account: 1619283, GL Balance: 47067, IHub Balance: 64672, Balance Difference: -17605, Match Status: Break, Discrepancy Category: Significant Discrepancy, Predicted Anomaly: Yes."
2,1619283,34312,40346,-6034,Break,Significant Discrepancy,1,"Company: 2, Account: 1619283, GL Balance: 34312, IHub Balance: 40346, Balance Difference: -6034, Match Status: Break, Discrepancy Category: Significant Discrepancy, Predicted Anomaly: Yes."
3,1619283,94880,84142,10738,Break,Significant Discrepancy,1,"Company: 3, Account: 1619283, GL Balance: 94880, IHub Balance: 84142, Balance Difference: 10738, Match Status: Break, Discrepancy Category: Significant Discrepancy, Predicted Anomaly: Yes."
2,1619283,80199,60298,19901,Break,Significant Discrepancy,1,"Company: 2, Account: 1619283, GL Balance: 80199, IHub Balance: 60298, Balance Difference: 19901, Match Status: Break, Discrepancy Category: Significant Discrepancy, Predicted Anomaly: Yes."
1,1619283,54225,65184,-10959,Break,Significant Discrepancy,1,"Company: 1, Account: 1619283, GL Balance: 54225, IHub Balance: 65184, Balance Difference: -10959, Match Status: Break, Discrepancy Category: Significant Discrepancy, Predicted Anomaly: Yes."
1,1619283,95853,43545,52308,Break,Significant Discrepancy,1,"Company: 1, Account: 1619283, GL Balance: 95853, IHub Balance: 43545, Balance Difference: 52308, Match Status: Break, Discrepancy Category: Significant Discrepancy, Predicted Anomaly: Yes."
2,1619283,83300,14019,69281,Break,Significant Discrepancy,1,"Company: 2, Account: 1619283, GL Balance: 83300, IHub Balance: 14019, Balance Difference: 69281, Match Status: Break, Discrepancy Category: Significant Discrepancy, Predicted Anomaly: Yes."
1,1619283,82322,43971,38351,Break,Significant Discrepancy,1,"Company: 1, Account: 1619283, GL Balance: 82322, IHub Balance: 43971, Balance Difference: 38351, Match Status: Break, Discrepancy Category: Significant Discrepancy, Predicted Anomaly: Yes."
2,1619283,14409,79035,-64626,Break,Significant Discrepancy,1,"Company: 2, Account: 1619283, GL Balance: 14409, IHub Balance: 79035, Balance Difference: -64626, Match Status: Break, Discrepancy Category: Significant Discrepancy, Predicted Anomaly: Yes."
3,1619283,24963,23435,1528,Break,Significant Discrepancy,1,"Company: 3, Account: 1619283, GL Balance: 24963, IHub Balance: 23435, Balance Difference: 1528, Match Status: Break, Discrepancy Category: Significant Discrepancy, Predicted Anomaly: Yes."
1,1619283,74860,46519,28341,Break,Significant Discrepancy,1,"Company: 1, Account: 1619283, GL Balance: 74860, IHub Balance: 46519, Balance Difference: 28341, Match Status: Break, Discrepancy Category: Significant Discrepancy, Predicted Anomaly: Yes."
2,1619283,87224,94416,-7192,Break,Significant Discrepancy,1,"Company: 2, Account: 1619283, GL Balance: 87224, IHub Balance: 94416, Balance Difference: -7192, Match Status: Break, Discrepancy Category: Significant Discrepancy, Predicted Anomaly: Yes."
3,1619283,70653,73333,-2680,Break,Significant Discrepancy,1,"Company: 3, Account: 1619283, GL Balance: 70653, IHub Balance: 73333, Balance Difference: -2680, Match Status: Break, Discrepancy Category: Significant Discrepancy, Predicted Anomaly: Yes."
1,1619283,45233,64711,-19478,Break,Significant Discrepancy,1,"Company: 1, Account: 1619283, GL Balance: 45233, IHub Balance: 64711, Balance Difference: -19478, Match Status: Break, Discrepancy Category: Significant Discrepancy, Predicted Anomaly: Yes."
2,1619283,30389,41533,-11144,Break,Significant Discrepancy,1,"Company: 2, Account: 1619283, GL Balance: 30389, IHub Balance: 41533, Balance Difference: -11144, Match Status: Break, Discrepancy Category: Significant Discrepancy, Predicted Anomaly: Yes."
3,1619283,55532,21351,34181,Break,Significant Discrepancy,1,"Company: 3, Account: 1619283, GL Balance: 55532, IHub Balance: 21351, Balance Difference: 34181, Match Status: Break, Discrepancy Category: Significant Discrepancy, Predicted Anomaly: Yes."
1,1619283,85542,14576,70966,Break,Significant Discrepancy,1,"Company: 1, Account: 1619283, GL Balance: 85542, IHub Balance: 14576, Balance Difference: 70966, Match Status: Break, Discrepancy Category: Significant Discrepancy, Predicted Anomaly: Yes."
3,1619283,31182,13775,17407,Break,Significant Discrepancy,1,"Company: 3, Account: 1619283, GL Balance: 31182, IHub Balance: 13775, Balance Difference: 17407, Match Status: Break, Discrepancy Category: Significant Discrepancy, Predicted Anomaly: Yes."
2,1619283,48262,99405,-51143,Break,Significant Discrepancy,1,"Company: 2, Account: 1619283, GL Balance: 48262, IHub Balance: 99405, Balance Difference: -51143, Match Status: Break, Discrepancy Category: Significant Discrepancy, Predicted Anomaly: Yes."
3,1619283,98031,74085,23946,Break,Significant Discrepancy,1,"Company: 3, Account: 1619283, GL Balance: 98031, IHub Balance: 74085, Balance Difference: 23946, Match Status: Break, Discrepancy Category: Significant Discrepancy, Predicted Anomaly: Yes."
1,1619283,12763,36148,-23385,Break,Significant Discrepancy,1,"Company: 1, Account: 1619283, GL Balance: 12763, IHub Balance: 36148, Balance Difference: -23385, Match Status: Break, Discrepancy Category: Significant Discrepancy, Predicted Anomaly: Yes."
2,1619283,39309,49574,-10265,Break,Significant Discrepancy,1,"Company: 2, Account: 1619283, GL Balance: 39309, IHub Balance: 49574, Balance Difference: -10265, Match Status: Break, Discrepancy Category: Significant Discrepancy, Predicted Anomaly: Yes."
2,1619283,53356,23882,29474,Break,Significant Discrepancy,1,"Company: 2, Account: 1619283, GL Balance: 53356, IHub Balance: 23882, Balance Difference: 29474, Match Status: Break, Discrepancy Category: Significant Discrepancy, Predicted Anomaly: Yes."
1,1619283,10002,79165,-69163,Break,Significant Discrepancy,1,"Company: 1, Account: 1619283, GL Balance: 10002, IHub Balance: 79165, Balance Difference: -69163, Match Status: Break, Discrepancy Category: Significant Discrepancy, Predicted Anomaly: Yes."
1,1619283,94629,83631,10998,Break,Significant Discrepancy,1,"Company: 1, Account: 1619283, GL Balance: 94629, IHub Balance: 83631, Balance Difference: 10998, Match Status: Break, Discrepancy Category: Significant Discrepancy, Predicted Anomaly: Yes."
3,1619283,97238,74170,23068,Break,Significant Discrepancy,1,"Company: 3, Account: 1619283, GL Balance: 97238, IHub Balance: 74170, Balance Difference: 23068, Match Status: Break, Discrepancy Category: Significant Discrepancy, Predicted Anomaly: Yes."
3,1619283,19587,89390,-69803,Break,Significant Discrepancy,1,"Company: 3, Account: 1619283, GL Balance: 19587, IHub Balance: 89390, Balance Difference: -69803, Match Status: Break, Discrepancy Category: Significant Discrepancy, Predicted Anomaly: Yes."
1,1619283,91720,45157,46563,Break,Significant Discrepancy,1,"Company: 1, Account: 1619283, GL Balance: 91720, IHub Balance: 45157, Balance Difference: 46563, Match Status: Break, Discrepancy Category: Significant Discrepancy, Predicted Anomaly: Yes."
3,1619283,34853,10427,24426,Break,Significant Discrepancy,1,"Company: 3, Account: 1619283, GL Balance: 34853, IHub Balance: 10427, Balance Difference: 24426, Match Status: Break, Discrepancy Category: Significant Discrepancy, Predicted Anomaly: Yes."
2,1619283,42583,87078,-44495,Break,Significant Discrepancy,1,"Company: 2, Account: 1619283, GL Balance: 42583, IHub Balance: 87078, Balance Difference: -44495, Match Status: Break, Discrepancy Category: Significant Discrepancy, Predicted Anomaly: Yes."
1,1619283,25704,74226,-48522,Break,Significant Discrepancy,1,"Company: 1, Account: 1619283, GL Balance: 25704, IHub Balance: 74226, Balance Difference: -48522, Match Status: Break, Discrepancy Category: Significant Discrepancy, Predicted Anomaly: Yes."
3,1619283,75715,12978,62737,Break,Significant Discrepancy,1,"Company: 3, Account: 1619283, GL Balance: 75715, IHub Balance: 12978, Balance Difference: 62737, Match Status: Break, Discrepancy Category: Significant Discrepancy, Predicted Anomaly: Yes."
3,1619283,99520,39550,59970,Break,Significant Discrepancy,1,"Company: 3, Account: 1619283, GL Balance: 99520, IHub Balance: 39550, Balance Difference: 59970, Match Status: Break, Discrepancy Category: Significant Discrepancy, Predicted Anomaly: Yes."
3,1619283,84163,11868,72295,Break,Significant Discrepancy,1,"Company: 3, Account: 1619283, GL Balance: 84163, IHub Balance: 11868, Balance Difference: 72295, Match Status: Break, Discrepancy Category: Significant Discrepancy, Predicted Anomaly: Yes."
1,1619283,79928,65918,14010,Break,Significant Discrepancy,1,"Company: 1, Account: 1619283, GL Balance: 79928, IHub Balance: 65918, Balance Difference: 14010, Match Status: Break, Discrepancy Category: Significant Discrepancy, Predicted Anomaly: Yes."
2,1619283,92793,47251,45542,Break,Significant Discrepancy,1,"Company: 2, Account: 1619283, GL Balance: 92793, IHub Balance: 47251, Balance Difference: 45542, Match Status: Break, Discrepancy Category: Significant Discrepancy, Predicted Anomaly: Yes."
1,1619283,72175,77428,-5253,Break,Significant Discrepancy,1,"Company: 1, Account: 1619283, GL Balance: 72175, IHub Balance: 77428, Balance Difference: -5253, Match Status: Break, Discrepancy Category: Significant Discrepancy, Predicted Anomaly: Yes."
1,1619283,82204,90210,-8006,Break,Significant Discrepancy,1,"Company: 1, Account: 1619283, GL Balance: 82204, IHub Balance: 90210, Balance Difference: -8006, Match Status: Break, Discrepancy Category: Significant Discrepancy, Predicted Anomaly: Yes."
3,1619283,36370,25831,10539,Break,Significant Discrepancy,1,"Company: 3, Account: 1619283, GL Balance: 36370, IHub Balance: 25831, Balance Difference: 10539, Match Status: Break, Discrepancy Category: Significant Discrepancy, Predicted Anomaly: Yes."
3,1619283,55679,17399,38280,Break,Significant Discrepancy,1,"Company: 3, Account: 1619283, GL Balance: 55679, IHub Balance: 17399, Balance Difference: 38280, Match Status: Break, Discrepancy Category: Significant Discrepancy, Predicted Anomaly: Yes."
1,1619283,26934,30344,-3410,Break,Significant Discrepancy,1,"Company: 1, Account: 1619283, GL Balance: 26934, IHub Balance: 30344, Balance Difference: -3410, Match Status: Break, Discrepancy Category: Significant Discrepancy, Predicted Anomaly: Yes."
1,1619283,49267,86772,-37505,Break,Significant Discrepancy,1,"Company: 1, Account: 1619283, GL Balance: 49267, IHub Balance: 86772, Balance Difference: -37505, Match Status: Break, Discrepancy Category: Significant Discrepancy, Predicted Anomaly: Yes."
2,1619283,98222,79835,18387,Break,Significant Discrepancy,1,"Company: 2, Account: 1619283, GL Balance: 98222, IHub Balance: 79835, Balance Difference: 18387, Match Status: Break, Discrepancy Category: Significant Discrepancy, Predicted Anomaly: Yes."
1,1619283,25037,32113,-7076,Break,Significant Discrepancy,1,"Company: 1, Account: 1619283, GL Balance: 25037, IHub Balance: 32113, Balance Difference: -7076, Match Status: Break, Discrepancy Category: Significant Discrepancy, Predicted Anomaly: Yes."
1,1619283,94853,61468,33385,Break,Significant Discrepancy,1,"Company: 1, Account: 1619283, GL Balance: 94853, IHub Balance: 61468, Balance Difference: 33385, Match Status: Break, Discrepancy Category: Significant Discrepancy, Predicted Anomaly: Yes."
1,1619283,58356,83438,-25082,Break,Significant Discrepancy,1,"Company: 1, Account: 1619283, GL Balance: 58356, IHub Balance: 83438, Balance Difference: -25082, Match Status: Break, Discrepancy Category: Significant Discrepancy, Predicted Anomaly: Yes."
2,1619283,79306,85160,-5854,Break,Significant Discrepancy,1,"Company: 2, Account: 1619283, GL Balance: 79306, IHub Balance: 85160, Balance Difference: -5854, Match Status: Break, Discrepancy Category: Significant Discrepancy, Predicted Anomaly: Yes."
3,1619283,65954,95350,-29396,Break,Significant Discrepancy,1,"Company: 3, Account: 1619283, GL Balance: 65954, IHub Balance: 95350, Balance Difference: -29396, Match Status: Break, Discrepancy Category: Significant Discrepancy, Predicted Anomaly: Yes."
2,1619283,91406,99670,-8264,Break,Significant Discrepancy,1,"Company: 2, Account: 1619283, GL Balance: 91406, IHub Balance: 99670, Balance Difference: -8264, Match Status: Break, Discrepancy Category: Significant Discrepancy, Predicted Anomaly: Yes."
2,1619283,48409,94739,-46330,Break,Significant Discrepancy,1,"Company: 2, Account: 1619283, GL Balance: 48409, IHub Balance: 94739, Balance Difference: -46330, Match Status: Break, Discrepancy Category: Significant Discrepancy, Predicted Anomaly: Yes."
1,1619283,12486,50954,-38468,Break,Significant Discrepancy,1,"Company: 1, Account: 1619283, GL Balance: 12486, IHub Balance: 50954, Balance Difference: -38468, Match Status: Break, Discrepancy Category: Significant Discrepancy, Predicted Anomaly: Yes."
1,1619283,75908,31346,44562,Break,Significant Discrepancy,1,"Company: 1, Account: 1619283, GL Balance: 75908, IHub Balance: 31346, Balance Difference: 44562, Match Status: Break, Discrepancy Category: Significant Discrepancy, Predicted Anomaly: Yes."
1,1619283,30684,53909,-23225,Break,Significant Discrepancy,1,"Company: 1, Account: 1619283, GL Balance: 30684, IHub Balance: 53909, Balance Difference: -23225, Match Status: Break, Discrepancy Category: Significant Discrepancy, Predicted Anomaly: Yes."
3,1619283,28595,49220,-20625,Break,Significant Discrepancy,1,"Company: 3, Account: 1619283, GL Balance: 28595, IHub Balance: 49220, Balance Difference: -20625, Match Status: Break, Discrepancy Category: Significant Discrepancy, Predicted Anomaly: Yes."
1,1619283,97640,71501,26139,Break,Significant Discrepancy,1,"Company: 1, Account: 1619283, GL Balance: 97640, IHub Balance: 71501, Balance Difference: 26139, Match Status: Break, Discrepancy Category: Significant Discrepancy, Predicted Anomaly: Yes."
1,1619283,32076,63380,-31304,Break,Significant Discrepancy,1,"Company: 1, Account: 1619283, GL Balance: 32076, IHub Balance: 63380, Balance Difference: -31304, Match Status: Break, Discrepancy Category: Significant Discrepancy, Predicted Anomaly: Yes."
3,1619283,55565,66174,-10609,Break,Significant Discrepancy,1,"Company: 3, Account: 1619283, GL Balance: 55565, IHub Balance: 66174, Balance Difference: -10609, Match Status: Break, Discrepancy Category: Significant Discrepancy, Predicted Anomaly: Yes."
3,1619283,20974,76226,-55252,Break,Significant Discrepancy,1,"Company: 3, Account: 1619283, GL Balance: 20974, IHub Balance: 76226, Balance Difference: -55252, Match Status: Break, Discrepancy Category: Significant Discrepancy, Predicted Anomaly: Yes."
2,1619283,62726,30637,32089,Break,Significant Discrepancy,1,"Company: 2, Account: 1619283, GL Balance: 62726, IHub Balance: 30637, Balance Difference: 32089, Match Status: Break, Discrepancy Category: Significant Discrepancy, Predicted Anomaly: Yes."
1,1619283,93151,48773,44378,Break,Significant Discrepancy,1,"Company: 1, Account: 1619283, GL Balance: 93151, IHub Balance: 48773, Balance Difference: 44378, Match Status: Break, Discrepancy Category: Significant Discrepancy, Predicted Anomaly: Yes."
1,1619283,44815,88947,-44132,Break,Significant Discrepancy,1,"Company: 1, Account: 1619283, GL Balance: 44815, IHub Balance: 88947, Balance Difference: -44132, Match Status: Break, Discrepancy Category: Significant Discrepancy, Predicted Anomaly: Yes."
3,1619283,49710,47271,2439,Break,Significant Discrepancy,1,"Company: 3, Account: 1619283, GL Balance: 49710, IHub Balance: 47271, Balance Difference: 2439, Match Status: Break, Discrepancy Category: Significant Discrepancy, Predicted Anomaly: Yes."
2,1619283,83508,67813,15695,Break,Significant Discrepancy,1,"Company: 2, Account: 1619283, GL Balance: 83508, IHub Balance: 67813, Balance Difference: 15695, Match Status: Break, Discrepancy Category: Significant Discrepancy, Predicted Anomaly: Yes."
2,1619283,42069,54891,-12822,Break,Significant Discrepancy,1,"Company: 2, Account: 1619283, GL Balance: 42069, IHub Balance: 54891, Balance Difference: -12822, Match Status: Break, Discrepancy Category: Significant Discrepancy, Predicted Anomaly: Yes."
3,1619283,35557,95279,-59722,Break,Significant Discrepancy,1,"Company: 3, Account: 1619283, GL Balance: 35557, IHub Balance: 95279, Balance Difference: -59722, Match Status: Break, Discrepancy Category: Significant Discrepancy, Predicted Anomaly: Yes."
1,1619283,70184,24126,46058,Break,Significant Discrepancy,1,"Company: 1, Account: 1619283, GL Balance: 70184, IHub Balance: 24126, Balance Difference: 46058, Match Status: Break, Discrepancy Category: Significant Discrepancy, Predicted Anomaly: Yes."
3,1619283,34406,22501,11905,Break,Significant Discrepancy,1,"Company: 3, Account: 1619283, GL Balance: 34406, IHub Balance: 22501, Balance Difference: 11905, Match Status: Break, Discrepancy Category: Significant Discrepancy, Predicted Anomaly: Yes."
2,1619283,52367,70686,-18319,Break,Significant Discrepancy,1,"Company: 2, Account: 1619283, GL Balance: 52367, IHub Balance: 70686, Balance Difference: -18319, Match Status: Break, Discrepancy Category: Significant Discrepancy, Predicted Anomaly: Yes."
1,1619283,57734,41017,16717,Break,Significant Discrepancy,1,"Company: 1, Account: 1619283, GL Balance: 57734, IHub Balance: 41017, Balance Difference: 16717, Match Status: Break, Discrepancy Category: Significant Discrepancy, Predicted Anomaly: Yes."
3,1619283,78122,84191,-6069,Break,Significant Discrepancy,1,"Company: 3, Account: 1619283, GL Balance: 78122, IHub Balance: 84191, Balance Difference: -6069, Match Status: Break, Discrepancy Category: Significant Discrepancy, Predicted Anomaly: Yes."
1,1619283,58380,52722,5658,Break,Significant Discrepancy,1,"Company: 1, Account: 1619283, GL Balance: 58380, IHub Balance: 52722, Balance Difference: 5658, Match Status: Break, Discrepancy Category: Significant Discrepancy, Predicted Anomaly: Yes."
3,1619283,59573,82762,-23189,Break,Significant Discrepancy,1,"Company: 3, Account: 1619283, GL Balance: 59573, IHub Balance: 82762, Balance Difference: -23189, Match Status: Break, Discrepancy Category: Significant Discrepancy, Predicted Anomaly: Yes."
2,1619283,16791,16704,87,Match,Other,0,"Company: 2, Account: 1619283, GL Balance: 16791, IHub Balance: 16704, Balance Difference: 87, Match Status: Match, Discrepancy Category: Other, Predicted Anomaly: No."
3,1619283,21345,50409,-29064,Break,Significant Discrepancy,1,"Company: 3, Account: 1619283, GL Balance: 21345, IHub Balance: 50409, Balance Difference: -29064, Match Status: Break, Discrepancy Category: Significant Discrepancy, Predicted Anomaly: Yes."
3,1619283,47563,46943,620,Match,Other,0,"Company: 3, Account: 1619283, GL Balance: 47563, IHub Balance: 46943, Balance Difference: 620, Match Status: Match, Discrepancy Category: Other, Predicted Anomaly: No."
1,1619283,98427,54472,43955,Break,Significant Discrepancy,1,"Company: 1, Account: 1619283, GL Balance: 98427, IHub Balance: 54472, Balance Difference: 43955, Match Status: Break, Discrepancy Category: Significant Discrepancy, Predicted Anomaly: Yes."
1,1619283,79224,18625,60599,Break,Significant Discrepancy,1,"Company: 1, Account: 1619283, GL Balance: 79224, IHub Balance: 18625, Balance Difference: 60599, Match Status: Break, Discrepancy Category: Significant Discrepancy, Predicted Anomaly: Yes."
3,1619283,38743,58068,-19325,Break,Significant Discrepancy,1,"Company: 3, Account: 1619283, GL Balance: 38743, IHub Balance: 58068, Balance Difference: -19325, Match Status: Break, Discrepancy Category: Significant Discrepancy, Predicted Anomaly: Yes."
3,1619283,77042,96555,-19513,Break,Significant Discrepancy,1,"Company: 3, Account: 1619283, GL Balance: 77042, IHub Balance: 96555, Balance Difference: -19513, Match Status: Break, Discrepancy Category: Significant Discrepancy, Predicted Anomaly: Yes."
1,1619283,26091,94193,-68102,Break,Significant Discrepancy,1,"Company: 1, Account: 1619283, GL Balance: 26091, IHub Balance: 94193, Balance Difference: -68102, Match Status: Break, Discrepancy Category: Significant Discrepancy, Predicted Anomaly: Yes."
1,1619283,66768,38900,27868,Break,Significant Discrepancy,1,"Company: 1, Account: 1619283, GL Balance: 66768, IHub Balance: 38900, Balance Difference: 27868, Match Status: Break, Discrepancy Category: Significant Discrepancy, Predicted Anomaly: Yes."
2,1619283,14018,83643,-69625,Break,Significant Discrepancy,1,"Company: 2, Account: 1619283, GL Balance: 14018, IHub Balance: 83643, Balance Difference: -69625, Match Status: Break, Discrepancy Category: Significant Discrepancy, Predicted Anomaly: Yes."
2,1619288,21249,48737,-27488,Break,Significant Discrepancy,1,"Company: 2, Account: 1619288, GL Balance: 21249, IHub Balance: 48737, Balance Difference: -27488, Match Status: Break, Discrepancy Category: Significant Discrepancy, Predicted Anomaly: Yes."
1,1619288,91867,25588,66279,Break,Significant Discrepancy,1,"Company: 1, Account: 1619288, GL Balance: 91867, IHub Balance: 25588, Balance Difference: 66279, Match Status: Break, Discrepancy Category: Significant Discrepancy, Predicted Anomaly: Yes."
1,1619288,28482,56710,-28228,Break,Significant Discrepancy,1,"Company: 1, Account: 1619288, GL Balance: 28482, IHub Balance: 56710, Balance Difference: -28228, Match Status: Break, Discrepancy Category: Significant Discrepancy, Predicted Anomaly: Yes."
1,1619288,45201,48314,-3113,Break,Significant Discrepancy,1,"Company: 1, Account: 1619288, GL Balance: 45201, IHub Balance: 48314, Balance Difference: -3113, Match Status: Break, Discrepancy Category: Significant Discrepancy, Predicted Anomaly: Yes."
2,1619288,67134,63863,3271,Break,Significant Discrepancy,1,"Company: 2, Account: 1619288, GL Balance: 67134, IHub Balance: 63863, Balance Difference: 3271, Match Status: Break, Discrepancy Category: Significant Discrepancy, Predicted Anomaly: Yes."
2,1619288,66565,65264,1301,Break,Significant Discrepancy,1,"Company: 2, Account: 1619288, GL Balance: 66565, IHub Balance: 65264, Balance Difference: 1301, Match Status: Break, Discrepancy Category: Significant Discrepancy, Predicted Anomaly: Yes."
1,1619288,81918,53284,28634,Break,Significant Discrepancy,1,"Company: 1, Account: 1619288, GL Balance: 81918, IHub Balance: 53284, Balance Difference: 28634, Match Status: Break, Discrepancy Category: Significant Discrepancy, Predicted Anomaly: Yes."
3,1619288,73001,18118,54883,Break,Significant Discrepancy,1,"Company: 3, Account: 1619288, GL Balance: 73001, IHub Balance: 18118, Balance Difference: 54883, Match Status: Break, Discrepancy Category: Significant Discrepancy, Predicted Anomaly: Yes."
3,1619288,41385,56716,-15331,Break,Significant Discrepancy,1,"Company: 3, Account: 1619288, GL Balance: 41385, IHub Balance: 56716, Balance Difference: -15331, Match Status: Break, Discrepancy Category: Significant Discrepancy, Predicted Anomaly: Yes."
2,1619288,86693,11502,75191,Break,Significant Discrepancy,1,"Company: 2, Account: 1619288, GL Balance: 86693, IHub Balance: 11502, Balance Difference: 75191, Match Status: Break, Discrepancy Category: Significant Discrepancy, Predicted Anomaly: Yes."
3,1619288,50100,22598,27502,Break,Significant Discrepancy,1,"Company: 3, Account: 1619288, GL Balance: 50100, IHub Balance: 22598, Balance Difference: 27502, Match Status: Break, Discrepancy Category: Significant Discrepancy, Predicted Anomaly: Yes."
3,1619288,29731,62234,-32503,Break,Significant Discrepancy,1,"Company: 3, Account: 1619288, GL Balance: 29731, IHub Balance: 62234, Balance Difference: -32503, Match Status: Break, Discrepancy Category: Significant Discrepancy, Predicted Anomaly: Yes."
3,1619288,59777,10660,49117,Break,Significant Discrepancy,1,"Company: 3, Account: 1619288, GL Balance: 59777, IHub Balance: 10660, Balance Difference: 49117, Match Status: Break, Discrepancy Category: Significant Discrepancy, Predicted Anomaly: Yes."
1,1619288,48699,37114,11585,Break,Significant Discrepancy,1,"Company: 1, Account: 1619288, GL Balance: 48699, IHub Balance: 37114, Balance Difference: 11585, Match Status: Break, Discrepancy Category: Significant Discrepancy, Predicted Anomaly: Yes."
1,1619288,42873,52676,-9803,Break,Significant Discrepancy,1,"Company: 1, Account: 1619288, GL Balance: 42873, IHub Balance: 52676, Balance Difference: -9803, Match Status: Break, Discrepancy Category: Significant Discrepancy, Predicted Anomaly: Yes."
3,1619288,21586,30125,-8539,Break,Significant Discrepancy,1,"Company: 3, Account: 1619288, GL Balance: 21586, IHub Balance: 30125, Balance Difference: -8539, Match Status: Break, Discrepancy Category: Significant Discrepancy, Predicted Anomaly: Yes."
3,1619288,17086,27040,-9954,Break,Significant Discrepancy,1,"Company: 3, Account: 1619288, GL Balance: 17086, IHub Balance: 27040, Balance Difference: -9954, Match Status: Break, Discrepancy Category: Significant Discrepancy, Predicted Anomaly: Yes."
2,1619288,14944,92476,-77532,Break,Significant Discrepancy,1,"Company: 2, Account: 1619288, GL Balance: 14944, IHub Balance: 92476, Balance Difference: -77532, Match Status: Break, Discrepancy Category: Significant Discrepancy, Predicted Anomaly: Yes."
2,1619288,73620,10765,62855,Break,Significant Discrepancy,1,"Company: 2, Account: 1619288, GL Balance: 73620, IHub Balance: 10765, Balance Difference: 62855, Match Status: Break, Discrepancy Category: Significant Discrepancy, Predicted Anomaly: Yes."
1,1619288,76249,75453,796,Match,Other,0,"Company: 1, Account: 1619288, GL Balance: 76249, IHub Balance: 75453, Balance Difference: 796, Match Status: Match, Discrepancy Category: Other, Predicted Anomaly: No."
3,1619288,35651,47180,-11529,Break,Significant Discrepancy,1,"Company: 3, Account: 1619288, GL Balance: 35651, IHub Balance: 47180, Balance Difference: -11529, Match Status: Break, Discrepancy Category: Significant Discrepancy, Predicted Anomaly: Yes."
3,1619288,22881,50138,-27257,Break,Significant Discrepancy,1,"Company: 3, Account: 1619288, GL Balance: 22881, IHub Balance: 50138, Balance Difference: -27257, Match Status: Break, Discrepancy Category: Significant Discrepancy, Predicted Anomaly: Yes."
3,1619288,46142,68382,-22240,Break,Significant Discrepancy,1,"Company: 3, Account: 1619288, GL Balance: 46142, IHub Balance: 68382, Balance Difference: -22240, Match Status: Break, Discrepancy Category: Significant Discrepancy, Predicted Anomaly: Yes."
3,1619288,87924,17634,70290,Break,Significant Discrepancy,1,"Company: 3, Account: 1619288, GL Balance: 87924, IHub Balance: 17634, Balance Difference: 70290, Match Status: Break, Discrepancy Category: Significant Discrepancy, Predicted Anomaly: Yes."
3,1619288,81494,14261,67233,Break,Significant Discrepancy,1,"Company: 3, Account: 1619288, GL Balance: 81494, IHub Balance: 14261, Balance Difference: 67233, Match Status: Break, Discrepancy Category: Significant Discrepancy, Predicted Anomaly: Yes."
3,1619288,86121,73355,12766,Break,Significant Discrepancy,1,"Company: 3, Account: 1619288, GL Balance: 86121, IHub Balance: 73355, Balance Difference: 12766, Match Status: Break, Discrepancy Category: Significant Discrepancy, Predicted Anomaly: Yes."
1,1619288,94793,16212,78581,Break,Significant Discrepancy,1,"Company: 1, Account: 1619288, GL Balance: 94793, IHub Balance: 16212, Balance Difference: 78581, Match Status: Break, Discrepancy Category: Significant Discrepancy, Predicted Anomaly: Yes."
2,1619288,55853,60934,-5081,Break,Significant Discrepancy,1,"Company: 2, Account: 1619288, GL Balance: 55853, IHub Balance: 60934, Balance Difference: -5081, Match Status: Break, Discrepancy Category: Significant Discrepancy, Predicted Anomaly: Yes."
1,1619288,56246,28344,27902,Break,Significant Discrepancy,1,"Company: 1, Account: 1619288, GL Balance: 56246, IHub Balance: 28344, Balance Difference: 27902, Match Status: Break, Discrepancy Category: Significant Discrepancy, Predicted Anomaly: Yes."
2,1619288,12889,29937,-17048,Break,Significant Discrepancy,1,"Company: 2, Account: 1619288, GL Balance: 12889, IHub Balance: 29937, Balance Difference: -17048, Match Status: Break, Discrepancy Category: Significant Discrepancy, Predicted Anomaly: Yes."
3,1619288,56404,26226,30178,Break,Significant Discrepancy,1,"Company: 3, Account: 1619288, GL Balance: 56404, IHub Balance: 26226, Balance Difference: 30178, Match Status: Break, Discrepancy Category: Significant Discrepancy, Predicted Anomaly: Yes."
2,1619288,14611,73985,-59374,Break,Significant Discrepancy,1,"Company: 2, Account: 1619288, GL Balance: 14611, IHub Balance: 73985, Balance Difference: -59374, Match Status: Break, Discrepancy Category: Significant Discrepancy, Predicted Anomaly: Yes."
2,1619288,92790,10496,82294,Break,Significant Discrepancy,1,"Company: 2, Account: 1619288, GL Balance: 92790, IHub Balance: 10496, Balance Difference: 82294, Match Status: Break, Discrepancy Category: Significant Discrepancy, Predicted Anomaly: Yes."
3,1619288,48383,35103,13280,Break,Significant Discrepancy,1,"Company: 3, Account: 1619288, GL Balance: 48383, IHub Balance: 35103, Balance Difference: 13280, Match Status: Break, Discrepancy Category: Significant Discrepancy, Predicted Anomaly: Yes."
3,1619288,99152,98263,889,Match,Other,0,"Company: 3, Account: 1619288, GL Balance: 99152, IHub Balance: 98263, Balance Difference: 889, Match Status: Match, Discrepancy Category: Other, Predicted Anomaly: No."
2,1619288,30140,82108,-51968,Break,Significant Discrepancy,1,"Company: 2, Account: 1619288, GL Balance: 30140, IHub Balance: 82108, Balance Difference: -51968, Match Status: Break, Discrepancy Category: Significant Discrepancy, Predicted Anomaly: Yes."
1,1619288,96912,17338,79574,Break,Significant Discrepancy,1,"Company: 1, Account: 1619288, GL Balance: 96912, IHub Balance: 17338, Balance Difference: 79574, Match Status: Break, Discrepancy Category: Significant Discrepancy, Predicted Anomaly: Yes."
2,1619288,98697,11074,87623,Break,Significant Discrepancy,1,"Company: 2, Account: 1619288, GL Balance: 98697, IHub Balance: 11074, Balance Difference: 87623, Match Status: Break, Discrepancy Category: Significant Discrepancy, Predicted Anomaly: Yes."
3,1619288,86575,36855,49720,Break,Significant Discrepancy,1,"Company: 3, Account: 1619288, GL Balance: 86575, IHub Balance: 36855, Balance Difference: 49720, Match Status: Break, Discrepancy Category: Significant Discrepancy, Predicted Anomaly: Yes."
2,1619288,35457,97273,-61816,Break,Significant Discrepancy,1,"Company: 2, Account: 1619288, GL Balance: 35457, IHub Balance: 97273, Balance Difference: -61816, Match Status: Break, Discrepancy Category: Significant Discrepancy, Predicted Anomaly: Yes."
1,1619288,10760,29996,-19236,Break,Significant Discrepancy,1,"Company: 1, Account: 1619288, GL Balance: 10760, IHub Balance: 29996, Balance Difference: -19236, Match Status: Break, Discrepancy Category: Significant Discrepancy, Predicted Anomaly: Yes."
1,1619288,32117,40565,-8448,Break,Significant Discrepancy,1,"Company: 1, Account: 1619288, GL Balance: 32117, IHub Balance: 40565, Balance Difference: -8448, Match Status: Break, Discrepancy Category: Significant Discrepancy, Predicted Anomaly: Yes."
2,1619288,25928,11160,14768,Break,Significant Discrepancy,1,"Company: 2, Account: 1619288, GL Balance: 25928, IHub Balance: 11160, Balance Difference: 14768, Match Status: Break, Discrepancy Category: Significant Discrepancy, Predicted Anomaly: Yes."
3,1619288,87271,72999,14272,Break,Significant Discrepancy,1,"Company: 3, Account: 1619288, GL Balance: 87271, IHub Balance: 72999, Balance Difference: 14272, Match Status: Break, Discrepancy Category: Significant Discrepancy, Predicted Anomaly: Yes."
2,1619288,28522,65479,-36957,Break,Significant Discrepancy,1,"Company: 2, Account: 1619288, GL Balance: 28522, IHub Balance: 65479, Balance Difference: -36957, Match Status: Break, Discrepancy Category: Significant Discrepancy, Predicted Anomaly: Yes."
1,1619288,74204,76540,-2336,Break,Significant Discrepancy,1,"Company: 1, Account: 1619288, GL Balance: 74204, IHub Balance: 76540, Balance Difference: -2336, Match Status: Break, Discrepancy Category: Significant Discrepancy, Predicted Anomaly: Yes."
3,1619288,89071,17498,71573,Break,Significant Discrepancy,1,"Company: 3, Account: 1619288, GL Balance: 89071, IHub Balance: 17498, Balance Difference: 71573, Match Status: Break, Discrepancy Category: Significant Discrepancy, Predicted Anomaly: Yes."
3,1619288,46490,67730,-21240,Break,Significant Discrepancy,1,"Company: 3, Account: 1619288, GL Balance: 46490, IHub Balance: 67730, Balance Difference: -21240, Match Status: Break, Discrepancy Category: Significant Discrepancy, Predicted Anomaly: Yes."
2,1619288,57829,52845,4984,Break,Significant Discrepancy,1,"Company: 2, Account: 1619288, GL Balance: 57829, IHub Balance: 52845, Balance Difference: 4984, Match Status: Break, Discrepancy Category: Significant Discrepancy, Predicted Anomaly: Yes."
1,1619288,15295,95836,-80541,Break,Significant Discrepancy,1,"Company: 1, Account: 1619288, GL Balance: 15295, IHub Balance: 95836, Balance Difference: -80541, Match Status: Break, Discrepancy Category: Significant Discrepancy, Predicted Anomaly: Yes."
2,1619288,53306,88018,-34712,Break,Significant Discrepancy,1,"Company: 2, Account: 1619288, GL Balance: 53306, IHub Balance: 88018, Balance Difference: -34712, Match Status: Break, Discrepancy Category: Significant Discrepancy, Predicted Anomaly: Yes."
1,1619288,65833,89702,-23869,Break,Significant Discrepancy,1,"Company: 1, Account: 1619288, GL Balance: 65833, IHub Balance: 89702, Balance Difference: -23869, Match Status: Break, Discrepancy Category: Significant Discrepancy, Predicted Anomaly: Yes."
2,1619288,66921,81325,-14404,Break,Significant Discrepancy,1,"Company: 2, Account: 1619288, GL Balance: 66921, IHub Balance: 81325, Balance Difference: -14404, Match Status: Break, Discrepancy Category: Significant Discrepancy, Predicted Anomaly: Yes."
1,1619288,88553,96787,-8234,Break,Significant Discrepancy,1,"Company: 1, Account: 1619288, GL Balance: 88553, IHub Balance: 96787, Balance Difference: -8234, Match Status: Break, Discrepancy Category: Significant Discrepancy, Predicted Anomaly: Yes."
2,1619288,12196,36548,-24352,Break,Significant Discrepancy,1,"Company: 2, Account: 1619288, GL Balance: 12196, IHub Balance: 36548, Balance Difference: -24352, Match Status: Break, Discrepancy Category: Significant Discrepancy, Predicted Anomaly: Yes."
2,1619288,39545,11391,28154,Break,Significant Discrepancy,1,"Company: 2, Account: 1619288, GL Balance: 39545, IHub Balance: 11391, Balance Difference: 28154, Match Status: Break, Discrepancy Category: Significant Discrepancy, Predicted Anomaly: Yes."
2,1619288,31329,51679,-20350,Break,Significant Discrepancy,1,"Company: 2, Account: 1619288, GL Balance: 31329, IHub Balance: 51679, Balance Difference: -20350, Match Status: Break, Discrepancy Category: Significant Discrepancy, Predicted Anomaly: Yes."
2,1619288,70776,44341,26435,Break,Significant Discrepancy,1,"Company: 2, Account: 1619288, GL Balance: 70776, IHub Balance: 44341, Balance Difference: 26435, Match Status: Break, Discrepancy Category: Significant Discrepancy, Predicted Anomaly: Yes."
2,1619288,81574,74514,7060,Break,Significant Discrepancy,1,"Company: 2, Account: 1619288, GL Balance: 81574, IHub Balance: 74514, Balance Difference: 7060, Match Status: Break, Discrepancy Category: Significant Discrepancy, Predicted Anomaly: Yes."
1,1619288,21595,27772,-6177,Break,Significant Discrepancy,1,"Company: 1, Account: 1619288, GL Balance: 21595, IHub Balance: 27772, Balance Difference: -6177, Match Status: Break, Discrepancy Category: Significant Discrepancy, Predicted Anomaly: Yes."
2,1619288,96148,94303,1845,Break,Significant Discrepancy,1,"Company: 2, Account: 1619288, GL Balance: 96148, IHub Balance: 94303, Balance Difference: 1845, Match Status: Break, Discrepancy Category: Significant Discrepancy, Predicted Anomaly: Yes."
2,1619288,15574,79778,-64204,Break,Significant Discrepancy,1,"Company: 2, Account: 1619288, GL Balance: 15574, IHub Balance: 79778, Balance Difference: -64204, Match Status: Break, Discrepancy Category: Significant Discrepancy, Predicted Anomaly: Yes."
1,1619288,61644,82154,-20510,Break,Significant Discrepancy,1,"Company: 1, Account: 1619288, GL Balance: 61644, IHub Balance: 82154, Balance Difference: -20510, Match Status: Break, Discrepancy Category: Significant Discrepancy, Predicted Anomaly: Yes."
3,1619288,19795,56146,-36351,Break,Significant Discrepancy,1,"Company: 3, Account: 1619288, GL Balance: 19795, IHub Balance: 56146, Balance Difference: -36351, Match Status: Break, Discrepancy Category: Significant Discrepancy, Predicted Anomaly: Yes."
3,1619288,89646,29333,60313,Break,Significant Discrepancy,1,"Company: 3, Account: 1619288, GL Balance: 89646, IHub Balance: 29333, Balance Difference: 60313, Match Status: Break, Discrepancy Category: Significant Discrepancy, Predicted Anomaly: Yes."
1,1619288,24691,95820,-71129,Break,Significant Discrepancy,1,"Company: 1, Account: 1619288, GL Balance: 24691, IHub Balance: 95820, Balance Difference: -71129, Match Status: Break, Discrepancy Category: Significant Discrepancy, Predicted Anomaly: Yes."
3,1619288,53220,37818,15402,Break,Significant Discrepancy,1,"Company: 3, Account: 1619288, GL Balance: 53220, IHub Balance: 37818, Balance Difference: 15402, Match Status: Break, Discrepancy Category: Significant Discrepancy, Predicted Anomaly: Yes."
2,1619288,88586,28594,59992,Break,Significant Discrepancy,1,"Company: 2, Account: 1619288, GL Balance: 88586, IHub Balance: 28594, Balance Difference: 59992, Match Status: Break, Discrepancy Category: Significant Discrepancy, Predicted Anomaly: Yes."
3,1619288,41958,78960,-37002,Break,Significant Discrepancy,1,"Company: 3, Account: 1619288, GL Balance: 41958, IHub Balance: 78960, Balance Difference: -37002, Match Status: Break, Discrepancy Category: Significant Discrepancy, Predicted Anomaly: Yes."
1,1619288,34722,76770,-42048,Break,Significant Discrepancy,1,"Company: 1, Account: 1619288, GL Balance: 34722, IHub Balance: 76770, Balance Difference: -42048, Match Status: Break, Discrepancy Category: Significant Discrepancy, Predicted Anomaly: Yes."
3,1619288,45771,15899,29872,Break,Significant Discrepancy,1,"Company: 3, Account: 1619288, GL Balance: 45771, IHub Balance: 15899, Balance Difference: 29872, Match Status: Break, Discrepancy Category: Significant Discrepancy, Predicted Anomaly: Yes."
2,1619288,54484,41568,12916,Break,Significant Discrepancy,1,"Company: 2, Account: 1619288, GL Balance: 54484, IHub Balance: 41568, Balance Difference: 12916, Match Status: Break, Discrepancy Category: Significant Discrepancy, Predicted Anomaly: Yes."
2,1619288,29510,97404,-67894,Break,Significant Discrepancy,1,"Company: 2, Account: 1619288, GL Balance: 29510, IHub Balance: 97404, Balance Difference: -67894, Match Status: Break, Discrepancy Category: Significant Discrepancy, Predicted Anomaly: Yes."
2,1619288,22755,46659,-23904,Break,Significant Discrepancy,1,"Company: 2, Account: 1619288, GL Balance: 22755, IHub Balance: 46659, Balance Difference: -23904, Match Status: Break, Discrepancy Category: Significant Discrepancy, Predicted Anomaly: Yes."
3,1619288,75888,80461,-4573,Break,Significant Discrepancy,1,"Company: 3, Account: 1619288, GL Balance: 75888, IHub Balance: 80461, Balance Difference: -4573, Match Status: Break, Discrepancy Category: Significant Discrepancy, Predicted Anomaly: Yes."
3,1619288,46069,84921,-38852,Break,Significant Discrepancy,1,"Company: 3, Account: 1619288, GL Balance: 46069, IHub Balance: 84921, Balance Difference: -38852, Match Status: Break, Discrepancy Category: Significant Discrepancy, Predicted Anomaly: Yes."
1,1619288,68706,37073,31633,Break,Significant Discrepancy,1,"Company: 1, Account: 1619288, GL Balance: 68706, IHub Balance: 37073, Balance Difference: 31633, Match Status: Break, Discrepancy Category: Significant Discrepancy, Predicted Anomaly: Yes."
1,1619288,36708,71394,-34686,Break,Significant Discrepancy,1,"Company: 1, Account: 1619288, GL Balance: 36708, IHub Balance: 71394, Balance Difference: -34686, Match Status: Break, Discrepancy Category: Significant Discrepancy, Predicted Anomaly: Yes."
3,1619288,46145,24746,21399,Break,Significant Discrepancy,1,"Company: 3, Account: 1619288, GL Balance: 46145, IHub Balance: 24746, Balance Difference: 21399, Match Status: Break, Discrepancy Category: Significant Discrepancy, Predicted Anomaly: Yes."
1,1619288,29622,48897,-19275,Break,Significant Discrepancy,1,"Company: 1, Account: 1619288, GL Balance: 29622, IHub Balance: 48897, Balance Difference: -19275, Match Status: Break, Discrepancy Category: Significant Discrepancy, Predicted Anomaly: Yes."
1,1619288,68601,88798,-20197,Break,Significant Discrepancy,1,"Company: 1, Account: 1619288, GL Balance: 68601, IHub Balance: 88798, Balance Difference: -20197, Match Status: Break, Discrepancy Category: Significant Discrepancy, Predicted Anomaly: Yes."
2,1619288,96713,13088,83625,Break,Significant Discrepancy,1,"Company: 2, Account: 1619288, GL Balance: 96713, IHub Balance: 13088, Balance Difference: 83625, Match Status: Break, Discrepancy Category: Significant Discrepancy, Predicted Anomaly: Yes."
3,1619288,90857,26375,64482,Break,Significant Discrepancy,1,"Company: 3, Account: 1619288, GL Balance: 90857, IHub Balance: 26375, Balance Difference: 64482, Match Status: Break, Discrepancy Category: Significant Discrepancy, Predicted Anomaly: Yes."
1,1619288,42544,38523,4021,Break,Significant Discrepancy,1,"Company: 1, Account: 1619288, GL Balance: 42544, IHub Balance: 38523, Balance Difference: 4021, Match Status: Break, Discrepancy Category: Significant Discrepancy, Predicted Anomaly: Yes."
3,1619288,86733,61939,24794,Break,Significant Discrepancy,1,"Company: 3, Account: 1619288, GL Balance: 86733, IHub Balance: 61939, Balance Difference: 24794, Match Status: Break, Discrepancy Category: Significant Discrepancy, Predicted Anomaly: Yes."
1,1619288,80199,14001,66198,Break,Significant Discrepancy,1,"Company: 1, Account: 1619288, GL Balance: 80199, IHub Balance: 14001, Balance Difference: 66198, Match Status: Break, Discrepancy Category: Significant Discrepancy, Predicted Anomaly: Yes."
1,1619288,47361,32689,14672,Break,Significant Discrepancy,1,"Company: 1, Account: 1619288, GL Balance: 47361, IHub Balance: 32689, Balance Difference: 14672, Match Status: Break, Discrepancy Category: Significant Discrepancy, Predicted Anomaly: Yes."
3,1619288,42305,94730,-52425,Break,Significant Discrepancy,1,"Company: 3, Account: 1619288, GL Balance: 42305, IHub Balance: 94730, Balance Difference: -52425, Match Status: Break, Discrepancy Category: Significant Discrepancy, Predicted Anomaly: Yes."
1,1619288,19967,21441,-1474,Break,Significant Discrepancy,1,"Company: 1, Account: 1619288, GL Balance: 19967, IHub Balance: 21441, Balance Difference: -1474, Match Status: Break, Discrepancy Category: Significant Discrepancy, Predicted Anomaly: Yes."
3,1619288,11597,22563,-10966,Break,Significant Discrepancy,1,"Company: 3, Account: 1619288, GL Balance: 11597, IHub Balance: 22563, Balance Difference: -10966, Match Status: Break, Discrepancy Category: Significant Discrepancy, Predicted Anomaly: Yes."
3,1619288,18493,44346,-25853,Break,Significant Discrepancy,1,"Company: 3, Account: 1619288, GL Balance: 18493, IHub Balance: 44346, Balance Difference: -25853, Match Status: Break, Discrepancy Category: Significant Discrepancy, Predicted Anomaly: Yes."
2,1619288,78752,54876,23876,Break,Significant Discrepancy,1,"Company: 2, Account: 1619288, GL Balance: 78752, IHub Balance: 54876, Balance Difference: 23876, Match Status: Break, Discrepancy Category: Significant Discrepancy, Predicted Anomaly: Yes."
3,1619288,84804,95603,-10799,Break,Significant Discrepancy,1,"Company: 3, Account: 1619288, GL Balance: 84804, IHub Balance: 95603, Balance Difference: -10799, Match Status: Break, Discrepancy Category: Significant Discrepancy, Predicted Anomaly: Yes."
3,1619288,65897,83551,-17654,Break,Significant Discrepancy,1,"Company: 3, Account: 1619288, GL Balance: 65897, IHub Balance: 83551, Balance Difference: -17654, Match Status: Break, Discrepancy Category: Significant Discrepancy, Predicted Anomaly: Yes."
3,1619288,91371,75092,16279,Break,Significant Discrepancy,1,"Company: 3, Account: 1619288, GL Balance: 91371, IHub Balance: 75092, Balance Difference: 16279, Match Status: Break, Discrepancy Category: Significant Discrepancy, Predicted Anomaly: Yes."
3,1619288,22213,95805,-73592,Break,Significant Discrepancy,1,"Company: 3, Account: 1619288, GL Balance: 22213, IHub Balance: 95805, Balance Difference: -73592, Match Status: Break, Discrepancy Category: Significant Discrepancy, Predicted Anomaly: Yes."
1,1619288,24274,95205,-70931,Break,Significant Discrepancy,1,"Company: 1, Account: 1619288, GL Balance: 24274, IHub Balance: 95205, Balance Difference: -70931, Match Status: Break, Discrepancy Category: Significant Discrepancy, Predicted Anomaly: Yes."
1,1619288,55312,70520,-15208,Break,Significant Discrepancy,1,"Company: 1, Account: 1619288, GL Balance: 55312, IHub Balance: 70520, Balance Difference: -15208, Match Status: Break, Discrepancy Category: Significant Discrepancy, Predicted Anomaly: Yes."
3,1619288,83273,13271,70002,Break,Significant Discrepancy,1,"Company: 3, Account: 1619288, GL Balance: 83273, IHub Balance: 13271, Balance Difference: 70002, Match Status: Break, Discrepancy Category: Significant Discrepancy, Predicted Anomaly: Yes."
3,1619288,80320,51787,28533,Break,Significant Discrepancy,1,"Company: 3, Account: 1619288, GL Balance: 80320, IHub Balance: 51787, Balance Difference: 28533, Match Status: Break, Discrepancy Category: Significant Discrepancy, Predicted Anomaly: Yes."
1,1619288,88345,76433,11912,Break,Significant Discrepancy,1,"Company: 1, Account: 1619288, GL Balance: 88345, IHub Balance: 76433, Balance Difference: 11912, Match Status: Break, Discrepancy Category: Significant Discrepancy, Predicted Anomaly: Yes."
3,1619288,66733,21179,45554,Break,Significant Discrepancy,1,"Company: 3, Account: 1619288, GL Balance: 66733, IHub Balance: 21179, Balance Difference: 45554, Match Status: Break, Discrepancy Category: Significant Discrepancy, Predicted Anomaly: Yes."
3,1619288,44629,21528,23101,Break,Significant Discrepancy,1,"Company: 3, Account: 1619288, GL Balance: 44629, IHub Balance: 21528, Balance Difference: 23101, Match Status: Break, Discrepancy Category: Significant Discrepancy, Predicted Anomaly: Yes."
2,1619288,78916,57703,21213,Break,Significant Discrepancy,1,"Company: 2, Account: 1619288, GL Balance: 78916, IHub Balance: 57703, Balance Difference: 21213, Match Status: Break, Discrepancy Category: Significant Discrepancy, Predicted Anomaly: Yes."
2,1619288,37331,37050,281,Match,Other,0,"Company: 2, Account: 1619288, GL Balance: 37331, IHub Balance: 37050, Balance Difference: 281, Match Status: Match, Discrepancy Category: Other, Predicted Anomaly: No."
3,1619288,10486,22500,-12014,Break,Significant Discrepancy,1,"Company: 3, Account: 1619288, GL Balance: 10486, IHub Balance: 22500, Balance Difference: -12014, Match Status: Break, Discrepancy Category: Significant Discrepancy, Predicted Anomaly: Yes."
2,1619288,80658,19628,61030,Break,Significant Discrepancy,1,"Company: 2, Account: 1619288, GL Balance: 80658, IHub Balance: 19628, Balance Difference: 61030, Match Status: Break, Discrepancy Category: Significant Discrepancy, Predicted Anomaly: Yes."
2,1619288,56371,31468,24903,Break,Significant Discrepancy,1,"Company: 2, Account: 1619288, GL Balance: 56371, IHub Balance: 31468, Balance Difference: 24903, Match Status: Break, Discrepancy Category: Significant Discrepancy, Predicted Anomaly: Yes."
2,1619288,33977,86292,-52315,Break,Significant Discrepancy,1,"Company: 2, Account: 1619288, GL Balance: 33977, IHub Balance: 86292, Balance Difference: -52315, Match Status: Break, Discrepancy Category: Significant Discrepancy, Predicted Anomaly: Yes."
2,1619288,57928,33769,24159,Break,Significant Discrepancy,1,"Company: 2, Account: 1619288, GL Balance: 57928, IHub Balance: 33769, Balance Difference: 24159, Match Status: Break, Discrepancy Category: Significant Discrepancy, Predicted Anomaly: Yes."
1,1619288,42624,39754,2870,Break,Significant Discrepancy,1,"Company: 1, Account: 1619288, GL Balance: 42624, IHub Balance: 39754, Balance Difference: 2870, Match Status: Break, Discrepancy Category: Significant Discrepancy, Predicted Anomaly: Yes."
3,1619288,97122,38834,58288,Break,Significant Discrepancy,1,"Company: 3, Account: 1619288, GL Balance: 97122, IHub Balance: 38834, Balance Difference: 58288, Match Status: Break, Discrepancy Category: Significant Discrepancy, Predicted Anomaly: Yes."
3,1619288,97086,57361,39725,Break,Significant Discrepancy,1,"Company: 3, Account: 1619288, GL Balance: 97086, IHub Balance: 57361, Balance Difference: 39725, Match Status: Break, Discrepancy Category: Significant Discrepancy, Predicted Anomaly: Yes."
1,1619288,79409,19422,59987,Break,Significant Discrepancy,1,"Company: 1, Account: 1619288, GL Balance: 79409, IHub Balance: 19422, Balance Difference: 59987, Match Status: Break, Discrepancy Category: Significant Discrepancy, Predicted Anomaly: Yes."
2,1619288,68418,69136,-718,Match,Other,0,"Company: 2, Account: 1619288, GL Balance: 68418, IHub Balance: 69136, Balance Difference: -718, Match Status: Match, Discrepancy Category: Other, Predicted Anomaly: No."
1,1619288,44457,98027,-53570,Break,Significant Discrepancy,1,"Company: 1, Account: 1619288, GL Balance: 44457, IHub Balance: 98027, Balance Difference: -53570, Match Status: Break, Discrepancy Category: Significant Discrepancy, Predicted Anomaly: Yes."
2,1619288,77421,10694,66727,Break,Significant Discrepancy,1,"Company: 2, Account: 1619288, GL Balance: 77421, IHub Balance: 10694, Balance Difference: 66727, Match Status: Break, Discrepancy Category: Significant Discrepancy, Predicted Anomaly: Yes."
3,1619288,85257,48985,36272,Break,Significant Discrepancy,1,"Company: 3, Account: 1619288, GL Balance: 85257, IHub Balance: 48985, Balance Difference: 36272, Match Status: Break, Discrepancy Category: Significant Discrepancy, Predicted Anomaly: Yes."
2,1619288,59228,19340,39888,Break,Significant Discrepancy,1,"Company: 2, Account: 1619288, GL Balance: 59228, IHub Balance: 19340, Balance Difference: 39888, Match Status: Break, Discrepancy Category: Significant Discrepancy, Predicted Anomaly: Yes."
1,1619288,84327,63024,21303,Break,Significant Discrepancy,1,"Company: 1, Account: 1619288, GL Balance: 84327, IHub Balance: 63024, Balance Difference: 21303, Match Status: Break, Discrepancy Category: Significant Discrepancy, Predicted Anomaly: Yes."
2,1619288,13258,63171,-49913,Break,Significant Discrepancy,1,"Company: 2, Account: 1619288, GL Balance: 13258, IHub Balance: 63171, Balance Difference: -49913, Match Status: Break, Discrepancy Category: Significant Discrepancy, Predicted Anomaly: Yes."
1,1619288,95269,88210,7059,Break,Significant Discrepancy,1,"Company: 1, Account: 1619288, GL Balance: 95269, IHub Balance: 88210, Balance Difference: 7059, Match Status: Break, Discrepancy Category: Significant Discrepancy, Predicted Anomaly: Yes."
3,1619288,19230,85851,-66621,Break,Significant Discrepancy,1,"Company: 3, Account: 1619288, GL Balance: 19230, IHub Balance: 85851, Balance Difference: -66621, Match Status: Break, Discrepancy Category: Significant Discrepancy, Predicted Anomaly: Yes."
3,1619288,58285,92001,-33716,Break,Significant Discrepancy,1,"Company: 3, Account: 1619288, GL Balance: 58285, IHub Balance: 92001, Balance Difference: -33716, Match Status: Break, Discrepancy Category: Significant Discrepancy, Predicted Anomaly: Yes."
3,1619288,56930,41541,15389,Break,Significant Discrepancy,1,"Company: 3, Account: 1619288, GL Balance: 56930, IHub Balance: 41541, Balance Difference: 15389, Match Status: Break, Discrepancy Category: Significant Discrepancy, Predicted Anomaly: Yes."
3,1619288,63175,98051,-34876,Break,Significant Discrepancy,1,"Company: 3, Account: 1619288, GL Balance: 63175, IHub Balance: 98051, Balance Difference: -34876, Match Status: Break, Discrepancy Category: Significant Discrepancy, Predicted Anomaly: Yes."
2,1619288,49291,79110,-29819,Break,Significant Discrepancy,1,"Company: 2, Account: 1619288, GL Balance: 49291, IHub Balance: 79110, Balance Difference: -29819, Match Status: Break, Discrepancy Category: Significant Discrepancy, Predicted Anomaly: Yes."
2,1619288,39381,18630,20751,Break,Significant Discrepancy,1,"Company: 2, Account: 1619288, GL Balance: 39381, IHub Balance: 18630, Balance Difference: 20751, Match Status: Break, Discrepancy Category: Significant Discrepancy, Predicted Anomaly: Yes."
2,1619288,36751,18080,18671,Break,Significant Discrepancy,1,"Company: 2, Account: 1619288, GL Balance: 36751, IHub Balance: 18080, Balance Difference: 18671, Match Status: Break, Discrepancy Category: Significant Discrepancy, Predicted Anomaly: Yes."
1,1619288,86850,86120,730,Match,Other,0,"Company: 1, Account: 1619288, GL Balance: 86850, IHub Balance: 86120, Balance Difference: 730, Match Status: Match, Discrepancy Category: Other, Predicted Anomaly: No."
1,1619288,45169,15206,29963,Break,Significant Discrepancy,1,"Company: 1, Account: 1619288, GL Balance: 45169, IHub Balance: 15206, Balance Difference: 29963, Match Status: Break, Discrepancy Category: Significant Discrepancy, Predicted Anomaly: Yes."
1,1619288,98220,29464,68756,Break,Significant Discrepancy,1,"Company: 1, Account: 1619288, GL Balance: 98220, IHub Balance: 29464, Balance Difference: 68756, Match Status: Break, Discrepancy Category: Significant Discrepancy, Predicted Anomaly: Yes."
2,1619288,24648,33772,-9124,Break,Significant Discrepancy,1,"Company: 2, Account: 1619288, GL Balance: 24648, IHub Balance: 33772, Balance Difference: -9124, Match Status: Break, Discrepancy Category: Significant Discrepancy, Predicted Anomaly: Yes."
2,1619288,44416,82577,-38161,Break,Significant Discrepancy,1,"Company: 2, Account: 1619288, GL Balance: 44416, IHub Balance: 82577, Balance Difference: -38161, Match Status: Break, Discrepancy Category: Significant Discrepancy, Predicted Anomaly: Yes."
2,1619288,82232,13770,68462,Break,Significant Discrepancy,1,"Company: 2, Account: 1619288, GL Balance: 82232, IHub Balance: 13770, Balance Difference: 68462, Match Status: Break, Discrepancy Category: Significant Discrepancy, Predicted Anomaly: Yes."
3,1619288,36425,63969,-27544,Break,Significant Discrepancy,1,"Company: 3, Account: 1619288, GL Balance: 36425, IHub Balance: 63969, Balance Difference: -27544, Match Status: Break, Discrepancy Category: Significant Discrepancy, Predicted Anomaly: Yes."
2,1619288,73294,68481,4813,Break,Significant Discrepancy,1,"Company: 2, Account: 1619288, GL Balance: 73294, IHub Balance: 68481, Balance Difference: 4813, Match Status: Break, Discrepancy Category: Significant Discrepancy, Predicted Anomaly: Yes."
1,1619288,92600,52623,39977,Break,Significant Discrepancy,1,"Company: 1, Account: 1619288, GL Balance: 92600, IHub Balance: 52623, Balance Difference: 39977, Match Status: Break, Discrepancy Category: Significant Discrepancy, Predicted Anomaly: Yes."
3,1619288,72619,88561,-15942,Break,Significant Discrepancy,1,"Company: 3, Account: 1619288, GL Balance: 72619, IHub Balance: 88561, Balance Difference: -15942, Match Status: Break, Discrepancy Category: Significant Discrepancy, Predicted Anomaly: Yes."
1,1619288,41075,71855,-30780,Break,Significant Discrepancy,1,"Company: 1, Account: 1619288, GL Balance: 41075, IHub Balance: 71855, Balance Difference: -30780, Match Status: Break, Discrepancy Category: Significant Discrepancy, Predicted Anomaly: Yes."
1,1619288,15752,85787,-70035,Break,Significant Discrepancy,1,"Company: 1, Account: 1619288, GL Balance: 15752, IHub Balance: 85787, Balance Difference: -70035, Match Status: Break, Discrepancy Category: Significant Discrepancy, Predicted Anomaly: Yes."
1,1619288,90391,92630,-2239,Break,Significant Discrepancy,1,"Company: 1, Account: 1619288, GL Balance: 90391, IHub Balance: 92630, Balance Difference: -2239, Match Status: Break, Discrepancy Category: Significant Discrepancy, Predicted Anomaly: Yes."
2,1619288,16853,25150,-8297,Break,Significant Discrepancy,1,"Company: 2, Account: 1619288, GL Balance: 16853, IHub Balance: 25150, Balance Difference: -8297, Match Status: Break, Discrepancy Category: Significant Discrepancy, Predicted Anomaly: Yes."
2,1619288,82723,92543,-9820,Break,Significant Discrepancy,1,"Company: 2, Account: 1619288, GL Balance: 82723, IHub Balance: 92543, Balance Difference: -9820, Match Status: Break, Discrepancy Category: Significant Discrepancy, Predicted Anomaly: Yes."
3,1619288,17848,39048,-21200,Break,Significant Discrepancy,1,"Company: 3, Account: 1619288, GL Balance: 17848, IHub Balance: 39048, Balance Difference: -21200, Match Status: Break, Discrepancy Category: Significant Discrepancy, Predicted Anomaly: Yes."
1,1619288,34843,35135,-292,Match,Other,0,"Company: 1, Account: 1619288, GL Balance: 34843, IHub Balance: 35135, Balance Difference: -292, Match Status: Match, Discrepancy Category: Other, Predicted Anomaly: No."
2,1619288,55382,30534,24848,Break,Significant Discrepancy,1,"Company: 2, Account: 1619288, GL Balance: 55382, IHub Balance: 30534, Balance Difference: 24848, Match Status: Break, Discrepancy Category: Significant Discrepancy, Predicted Anomaly: Yes."
3,1619288,71527,48736,22791,Break,Significant Discrepancy,1,"Company: 3, Account: 1619288, GL Balance: 71527, IHub Balance: 48736, Balance Difference: 22791, Match Status: Break, Discrepancy Category: Significant Discrepancy, Predicted Anomaly: Yes."
2,1619288,11559,32588,-21029,Break,Significant Discrepancy,1,"Company: 2, Account: 1619288, GL Balance: 11559, IHub Balance: 32588, Balance Difference: -21029, Match Status: Break, Discrepancy Category: Significant Discrepancy, Predicted Anomaly: Yes."
3,1619288,26940,16610,10330,Break,Significant Discrepancy,1,"Company: 3, Account: 1619288, GL Balance: 26940, IHub Balance: 16610, Balance Difference: 10330, Match Status: Break, Discrepancy Category: Significant Discrepancy, Predicted Anomaly: Yes."
1,1619288,28385,41285,-12900,Break,Significant Discrepancy,1,"Company: 1, Account: 1619288, GL Balance: 28385, IHub Balance: 41285, Balance Difference: -12900, Match Status: Break, Discrepancy Category: Significant Discrepancy, Predicted Anomaly: Yes."
1,1619288,62204,27140,35064,Break,Significant Discrepancy,1,"Company: 1, Account: 1619288, GL Balance: 62204, IHub Balance: 27140, Balance Difference: 35064, Match Status: Break, Discrepancy Category: Significant Discrepancy, Predicted Anomaly: Yes."
1,1619288,39480,92413,-52933,Break,Significant Discrepancy,1,"Company: 1, Account: 1619288, GL Balance: 39480, IHub Balance: 92413, Balance Difference: -52933, Match Status: Break, Discrepancy Category: Significant Discrepancy, Predicted Anomaly: Yes."
1,1619288,56144,47696,8448,Break,Significant Discrepancy,1,"Company: 1, Account: 1619288, GL Balance: 56144, IHub Balance: 47696, Balance Difference: 8448, Match Status: Break, Discrepancy Category: Significant Discrepancy, Predicted Anomaly: Yes."
1,1619288,71256,85582,-14326,Break,Significant Discrepancy,1,"Company: 1, Account: 1619288, GL Balance: 71256, IHub Balance: 85582, Balance Difference: -14326, Match Status: Break, Discrepancy Category: Significant Discrepancy, Predicted Anomaly: Yes."
3,1619288,98207,27152,71055,Break,Significant Discrepancy,1,"Company: 3, Account: 1619288, GL Balance: 98207, IHub Balance: 27152, Balance Difference: 71055, Match Status: Break, Discrepancy Category: Significant Discrepancy, Predicted Anomaly: Yes."
3,1619288,41498,88467,-46969,Break,Significant Discrepancy,1,"Company: 3, Account: 1619288, GL Balance: 41498, IHub Balance: 88467, Balance Difference: -46969, Match Status: Break, Discrepancy Category: Significant Discrepancy, Predicted Anomaly: Yes."
1,1619288,25863,77945,-52082,Break,Significant Discrepancy,1,"Company: 1, Account: 1619288, GL Balance: 25863, IHub Balance: 77945, Balance Difference: -52082, Match Status: Break, Discrepancy Category: Significant Discrepancy, Predicted Anomaly: Yes."
3,1619288,28051,89915,-61864,Break,Significant Discrepancy,1,"Company: 3, Account: 1619288, GL Balance: 28051, IHub Balance: 89915, Balance Difference: -61864, Match Status: Break, Discrepancy Category: Significant Discrepancy, Predicted Anomaly: Yes."
2,1619288,78470,72543,5927,Break,Significant Discrepancy,1,"Company: 2, Account: 1619288, GL Balance: 78470, IHub Balance: 72543, Balance Difference: 5927, Match Status: Break, Discrepancy Category: Significant Discrepancy, Predicted Anomaly: Yes."
3,1619288,72894,37414,35480,Break,Significant Discrepancy,1,"Company: 3, Account: 1619288, GL Balance: 72894, IHub Balance: 37414, Balance Difference: 35480, Match Status: Break, Discrepancy Category: Significant Discrepancy, Predicted Anomaly: Yes."
2,1619288,26142,60016,-33874,Break,Significant Discrepancy,1,"Company: 2, Account: 1619288, GL Balance: 26142, IHub Balance: 60016, Balance Difference: -33874, Match Status: Break, Discrepancy Category: Significant Discrepancy, Predicted Anomaly: Yes."
1,1619288,30372,40844,-10472,Break,Significant Discrepancy,1,"Company: 1, Account: 1619288, GL Balance: 30372, IHub Balance: 40844, Balance Difference: -10472, Match Status: Break, Discrepancy Category: Significant Discrepancy, Predicted Anomaly: Yes."
2,1619288,62243,92335,-30092,Break,Significant Discrepancy,1,"Company: 2, Account: 1619288, GL Balance: 62243, IHub Balance: 92335, Balance Difference: -30092, Match Status: Break, Discrepancy Category: Significant Discrepancy, Predicted Anomaly: Yes."
3,1619288,49851,79224,-29373,Break,Significant Discrepancy,1,"Company: 3, Account: 1619288, GL Balance: 49851, IHub Balance: 79224, Balance Difference: -29373, Match Status: Break, Discrepancy Category: Significant Discrepancy, Predicted Anomaly: Yes."
2,1619288,79619,40285,39334,Break,Significant Discrepancy,1,"Company: 2, Account: 1619288, GL Balance: 79619, IHub Balance: 40285, Balance Difference: 39334, Match Status: Break, Discrepancy Category: Significant Discrepancy, Predicted Anomaly: Yes."
3,1619288,82914,55468,27446,Break,Significant Discrepancy,1,"Company: 3, Account: 1619288, GL Balance: 82914, IHub Balance: 55468, Balance Difference: 27446, Match Status: Break, Discrepancy Category: Significant Discrepancy, Predicted Anomaly: Yes."
2,1619288,10559,63555,-52996,Break,Significant Discrepancy,1,"Company: 2, Account: 1619288, GL Balance: 10559, IHub Balance: 63555, Balance Difference: -52996, Match Status: Break, Discrepancy Category: Significant Discrepancy, Predicted Anomaly: Yes."
3,1619288,67893,59810,8083,Break,Significant Discrepancy,1,"Company: 3, Account: 1619288, GL Balance: 67893, IHub Balance: 59810, Balance Difference: 8083, Match Status: Break, Discrepancy Category: Significant Discrepancy, Predicted Anomaly: Yes."
3,1619288,23806,56732,-32926,Break,Significant Discrepancy,1,"Company: 3, Account: 1619288, GL Balance: 23806, IHub Balance: 56732, Balance Difference: -32926, Match Status: Break, Discrepancy Category: Significant Discrepancy, Predicted Anomaly: Yes."
3,1619288,59390,32331,27059,Break,Significant Discrepancy,1,"Company: 3, Account: 1619288, GL Balance: 59390, IHub Balance: 32331, Balance Difference: 27059, Match Status: Break, Discrepancy Category: Significant Discrepancy, Predicted Anomaly: Yes."
1,1619288,23541,39455,-15914,Break,Significant Discrepancy,1,"Company: 1, Account: 1619288, GL Balance: 23541, IHub Balance: 39455, Balance Difference: -15914, Match Status: Break, Discrepancy Category: Significant Discrepancy, Predicted Anomaly: Yes."
3,1619288,67450,24716,42734,Break,Significant Discrepancy,1,"Company: 3, Account: 1619288, GL Balance: 67450, IHub Balance: 24716, Balance Difference: 42734, Match Status: Break, Discrepancy Category: Significant Discrepancy, Predicted Anomaly: Yes."
3,1619288,20973,79506,-58533,Break,Significant Discrepancy,1,"Company: 3, Account: 1619288, GL Balance: 20973, IHub Balance: 79506, Balance Difference: -58533, Match Status: Break, Discrepancy Category: Significant Discrepancy, Predicted Anomaly: Yes."
1,1619288,70303,27118,43185,Break,Significant Discrepancy,1,"Company: 1, Account: 1619288, GL Balance: 70303, IHub Balance: 27118, Balance Difference: 43185, Match Status: Break, Discrepancy Category: Significant Discrepancy, Predicted Anomaly: Yes."
1,1619288,64149,81200,-17051,Break,Significant Discrepancy,1,"Company: 1, Account: 1619288, GL Balance: 64149, IHub Balance: 81200, Balance Difference: -17051, Match Status: Break, Discrepancy Category: Significant Discrepancy, Predicted Anomaly: Yes."
1,1619288,19569,64290,-44721,Break,Significant Discrepancy,1,"Company: 1, Account: 1619288, GL Balance: 19569, IHub Balance: 64290, Balance Difference: -44721, Match Status: Break, Discrepancy Category: Significant Discrepancy, Predicted Anomaly: Yes."
1,1619288,70998,20846,50152,Break,Significant Discrepancy,1,"Company: 1, Account: 1619288, GL Balance: 70998, IHub Balance: 20846, Balance Difference: 50152, Match Status: Break, Discrepancy Category: Significant Discrepancy, Predicted Anomaly: Yes."
3,1619288,31390,12620,18770,Break,Significant Discrepancy,1,"Company: 3, Account: 1619288, GL Balance: 31390, IHub Balance: 12620, Balance Difference: 18770, Match Status: Break, Discrepancy Category: Significant Discrepancy, Predicted Anomaly: Yes."
1,1619288,90720,74356,16364,Break,Significant Discrepancy,1,"Company: 1, Account: 1619288, GL Balance: 90720, IHub Balance: 74356, Balance Difference: 16364, Match Status: Break, Discrepancy Category: Significant Discrepancy, Predicted Anomaly: Yes."
2,1619288,55771,43697,12074,Break,Significant Discrepancy,1,"Company: 2, Account: 1619288, GL Balance: 55771, IHub Balance: 43697, Balance Difference: 12074, Match Status: Break, Discrepancy Category: Significant Discrepancy, Predicted Anomaly: Yes."
1,1619288,71260,29159,42101,Break,Significant Discrepancy,1,"Company: 1, Account: 1619288, GL Balance: 71260, IHub Balance: 29159, Balance Difference: 42101, Match Status: Break, Discrepancy Category: Significant Discrepancy, Predicted Anomaly: Yes."
1,1619288,85603,71451,14152,Break,Significant Discrepancy,1,"Company: 1, Account: 1619288, GL Balance: 85603, IHub Balance: 71451, Balance Difference: 14152, Match Status: Break, Discrepancy Category: Significant Discrepancy, Predicted Anomaly: Yes."
3,1619288,96029,93551,2478,Break,Significant Discrepancy,1,"Company: 3, Account: 1619288, GL Balance: 96029, IHub Balance: 93551, Balance Difference: 2478, Match Status: Break, Discrepancy Category: Significant Discrepancy, Predicted Anomaly: Yes."
2,1619288,95395,71562,23833,Break,Significant Discrepancy,1,"Company: 2, Account: 1619288, GL Balance: 95395, IHub Balance: 71562, Balance Difference: 23833, Match Status: Break, Discrepancy Category: Significant Discrepancy, Predicted Anomaly: Yes."
2,1619288,87116,79650,7466,Break,Significant Discrepancy,1,"Company: 2, Account: 1619288, GL Balance: 87116, IHub Balance: 79650, Balance Difference: 7466, Match Status: Break, Discrepancy Category: Significant Discrepancy, Predicted Anomaly: Yes."
2,1619288,89431,31767,57664,Break,Significant Discrepancy,1,"Company: 2, Account: 1619288, GL Balance: 89431, IHub Balance: 31767, Balance Difference: 57664, Match Status: Break, Discrepancy Category: Significant Discrepancy, Predicted Anomaly: Yes."
1,1619288,58506,30256,28250,Break,Significant Discrepancy,1,"Company: 1, Account: 1619288, GL Balance: 58506, IHub Balance: 30256, Balance Difference: 28250, Match Status: Break, Discrepancy Category: Significant Discrepancy, Predicted Anomaly: Yes."
3,1619288,44381,58591,-14210,Break,Significant Discrepancy,1,"Company: 3, Account: 1619288, GL Balance: 44381, IHub Balance: 58591, Balance Difference: -14210, Match Status: Break, Discrepancy Category: Significant Discrepancy, Predicted Anomaly: Yes."
3,1619288,18749,30054,-11305,Break,Significant Discrepancy,1,"Company: 3, Account: 1619288, GL Balance: 18749, IHub Balance: 30054, Balance Difference: -11305, Match Status: Break, Discrepancy Category: Significant Discrepancy, Predicted Anomaly: Yes."
2,1619288,52782,66985,-14203,Break,Significant Discrepancy,1,"Company: 2, Account: 1619288, GL Balance: 52782, IHub Balance: 66985, Balance Difference: -14203, Match Status: Break, Discrepancy Category: Significant Discrepancy, Predicted Anomaly: Yes."
2,1619288,35738,43822,-8084,Break,Significant Discrepancy,1,"Company: 2, Account: 1619288, GL Balance: 35738, IHub Balance: 43822, Balance Difference: -8084, Match Status: Break, Discrepancy Category: Significant Discrepancy, Predicted Anomaly: Yes."
1,1619288,49419,77264,-27845,Break,Significant Discrepancy,1,"Company: 1, Account: 1619288, GL Balance: 49419, IHub Balance: 77264, Balance Difference: -27845, Match Status: Break, Discrepancy Category: Significant Discrepancy, Predicted Anomaly: Yes."
1,1619288,71772,91641,-19869,Break,Significant Discrepancy,1,"Company: 1, Account: 1619288, GL Balance: 71772, IHub Balance: 91641, Balance Difference: -19869, Match Status: Break, Discrepancy Category: Significant Discrepancy, Predicted Anomaly: Yes."
3,1619288,78184,74791,3393,Break,Significant Discrepancy,1,"Company: 3, Account: 1619288, GL Balance: 78184, IHub Balance: 74791, Balance Difference: 3393, Match Status: Break, Discrepancy Category: Significant Discrepancy, Predicted Anomaly: Yes."
1,1619288,14331,70848,-56517,Break,Significant Discrepancy,1,"Company: 1, Account: 1619288, GL Balance: 14331, IHub Balance: 70848, Balance Difference: -56517, Match Status: Break, Discrepancy Category: Significant Discrepancy, Predicted Anomaly: Yes."
